30 100
ACTGCGCAACTTTGTCAGCCTTTGACGACC|TTTCTCTGTGTAGCCTGAGGCCGTGTGAGG
CATTGTACCAAATCAGTACCACCAAGATTT|CAGAGAGGACTAGACTTAGGAGAACGACAT
AGCGAGAGCGGTGATAAGAGAGGCCATCTC|TGACCATAAGAATTGTGCGTTTTTGTCCAA
TAAAGAGATGAGCAGGCGTACCGTGTGAGG|CCGTGTGAGGAGATGTGACCATAAGAATTG
CCGCGCGTGTTCGTTGGCTTAGATCTGTTT|TCTCAGCCGTATGATAAGAAGCCGTGTATA
GAGGAGATGTGACCATAAGAATTGTAAGAA|GACACCGTGATCCCGTGTGAGGAGATGTGA
TATGAAAGGAGTAGTAGGGGTGTGGGGTAA|TGCGCTATCCGGTTCCTTTTCGCACCACCG
GAATGGCCGTCGTGTCGTGTTGACCGTATG|GGACCCCGGGTCCATCAAACTAAGACTGCG
GAATCAATCTTTAAATGCCCAGGGAGCCGG|CCGTGTGAGGAGATGTGACCATAAGAATTG
ATTGCAGCTAACTTACCGTCCGTGTGAGGA|CCATACCGTGTGAGGAGATGTGACCACCGT
GGAGATGTGACCATAAGAATTGAGACACTC|GTGAGGAGATGTGACCATAAGAATTGGTAA
ATGTGACCATAAGAATTGATCCGTGTGAGG|GATTTGGCCAATCACTAAATGGTTATCAGC
GATCAGTGCCGTCCTCGATTTCACCTTCCG|CAGAGTGAAACGTACACGACTGTTATGCTG
TGTGAGGAGATGTGACCATAAGAATTGCTT|CACTGCGCAACTTTGTCAGCCTTTGACGAC
GTGACCATAAGAATTGAGACATAGACATTG|TCTCAAACTTGCAGACATCTTACCCGTTCA
GTACTGCGCCTGTGCATCTGGGTTGTCGAT|AATTGAGACATAGACATTGCCAACACACAG
TGGGTTGTCGATCAGTGCCGTCCTCGATTT|GCCAACACACAGAGTGAAACGTACACGACT
ACGACTGTTATGCTGCACTGCGCAACTTTG|TGAGAAAGGCCACTGATTTCTCTGTGTAGC
TTTCGCACCACCGTGTGAGGAGATGTGACC|CCATAAGAATTCCGTGTGAGGAGATGTGAC
CAGAGTGAAACGTACACGACTGTTATGCTG|CTGTTAGATACGTTTTGAGAAAGGCCACTG
TACCAAATCAGTACCACCAAGATTTGGGCC|AGGACTAGACTTAGGAGAACGACATGGGTT
ATGGCCGTCGTGTCGTGTTGACCGTATGAA|ACCCCGGGTCCATCAAACTAAGACTGCGCT
CAGGACCAGTAAGAAGGGGACCCCGGGTCC|AAGTATCACATTGTACCAAATCAGTACCAC
CTTGCAGACATCTTACCCGTTCAATCAGTA|TACGAATGGCCGTCGTGTCGTGTTGACCGT
GTGAGGAGATGTGACCATAAGAATTGGCCG|TGTGAGGAGATGTGACCATAAGAATTGGTC
TCCGTGTGAGGAGATGTGACCATAAGAATT|TGGTTATCAGCGGACCGCAATTCGATTCTG
CCATAAGAATTGAGACACTCCGGTAGAATT|GTGACCATAAGAATTGGTAAGCTTCCGGAT
TTATCACTTTTATGTAACCGTGTGAGGAGA|ATCCGATTATAATAGGCTGGGTATGGTATG
CCTTTCAACGAATCAATCTTTAAATGCCCA|TTTATGTAACCGTGTGAGGAGATGTGACCA
TATCACATTGTACCAAATCAGTACCACCAA|GCGTTCAGAGAGGACTAGACTTAGGAGAAC
AGGAGATGTGACCATAAGAATTGTTTGAGC|TTGGCCGGCGTTCGTTGTTGAGTTGCAAAC
TCGAGCGATAGGGGCCATCGCAACGGTATT|ATAAGAATTGACCAACTGGCGCCGCGCGTG
AAGCTTCCGGATCCGATTATAATAGGCTGG|CCTGTGCATCTGGGTTGTCGATCAGTGCCG
CATAAGAATTGTGCGTTTTTGTCCAATGGT|AATTGTTTGAGCTTCCAGGACCAGTAAGAA
TGTCCAATGGTACGAATGGCCGTCGTGTCG|ACCAGTAAGAAGGGGACCCCGGGTCCATCA
TCAGAGAGGACTAGACTTAGGAGAACGACA|TGGCTTAGATCTGTTTTTTCCTAGCTGTAA
AGATGTGACCATAAGAATTGGCCGGCGTTC|GAGATGTGACCATAAGAATTGGTCGAGCGA
GTACCATACGGCAACGCTATATGGGCAGGG|CTAACTTACCGTCCGTGTGAGGAGATGTGA
TGCCCAGGGAGCCGGCGTGTACCATACGGC|TGACCATAAGAATTGCAGCTAACTTACCGT
CCATAAGAATTGCTTACCAATGACACCGTG|TCAGCCTTTGACGACCGCGAAAGCGAGAGC
CGCCGCGCGTGTTCGTTGGCTTAGATCTGT|TCTCTCAGCCGTATGATAAGAAGCCGTGTA
ACCATAAGAATTGAGACACTCCGGTAGAAT|TGTGACCATAAGAATTGGTAAGCTTCCGGA
TGACCATAAGAATTGCTTACCAATGACACC|TTGTCAGCCTTTGACGACCGCGAAAGCGAG
GCTATCCGGTTCCTTTTCGCACCACCGTGT|GTGAGGAGATGTGACCATAAGAATTCCGTG
CCGGTTCCTTTTCGCACCACCGTGTGAGGA|GAGATGTGACCATAAGAATTCCGTGTGAGG
GAGAGCGGTGATAAGAGAGGCCATCTCAAA|CCATAAGAATTGTGCGTTTTTGTCCAATGG
ACCGTGTGAGGAGATGTGACCATAAGAATT|TTCCGTGTGAGGAGATGTGACCATAAGAAT
CAGTAGCTGTTAGATACGTTTTGAGAAAGG|ACCGTATGAAAGGAGTAGTAGGGGTGTGGG
GTTTGAGCTTCCAGGACCAGTAAGAAGGGG|TTGCAAACTTCAAGTATCACATTGTACCAA
GTGACCATAAGAATTGACCAACTGGCGCCG|CGCAATTCGATTCTGAGGGATGTCGTCTCT
ACCATAAGAATTGGTAAGCTTCCGGATCCG|TTGATGTGTACTGCGCCTGTGCATCTGGGT
CGTGTGAGGAGATGTGACCATAAGAATTGT|TAAGAATTGGCCGGCGTTCGTTGTTGAGTT
ACCACCGTGTGAGGAGATGTGACCATAAGA|GCTTACCAATGACACCGTGATCCCGTGTGA
AAAGGAGTAGTAGGGGTGTGGGGTAAAGAG|CTATCCGGTTCCTTTTCGCACCACCGTGTG
GGTATGGTATGCCCACGGTGGCGGCCATAC|GTCCTCGATTTCACCTTCCGTGTGAGGAGA
GCGCAACTTTGTCAGCCTTTGACGACCGCG|CTCTGTGTAGCCTGAGGCCGTGTGAGGAGA
AATTGATGTGTACTGCGCCTGTGCATCTGG|GACCATAAGAATTGAGACATAGACATTGCC
GACCATAAGAATTGTGCGTTTTTGTCCAAT|AAGAATTGTTTGAGCTTCCAGGACCAGTAA
TGTGCATCTGGGTTGTCGATCAGTGCCGTC|TAGACATTGCCAACACACAGAGTGAAACGT
AAGACTGCGCTATCCGGTTCCTTTTCGCAC|GGGCCCGTGTGAGGAGATGTGACCATAAGA
TTGGCCGGCGTTCGTTGTTGAGTTGCAAAC|ATTGGTCGAGCGATAGGGGCCATCGCAACG
AACGAATCAATCTTTAAATGCCCAGGGAGC|TAACCGTGTGAGGAGATGTGACCATAAGAA
TATAATAGGCTGGGTATGGTATGCCCACGG|TCGATCAGTGCCGTCCTCGATTTCACCTTC
GAGATGTGACCATAAGAATTGTTTGAGCTT|GGCCGGCGTTCGTTGTTGAGTTGCAAACTT
TTGATGTGTACTGCGCCTGTGCATCTGGGT|CCATAAGAATTGAGACATAGACATTGCCAA
TCGCACCACCGTGTGAGGAGATGTGACCAT|ATAAGAATTCCGTGTGAGGAGATGTGACCA
TGACCATAAGAATTGATCCGTGTGAGGAGA|TTGGCCAATCACTAAATGGTTATCAGCGGA
ATAAGAATTGTTTGAGCTTCCAGGACCAGT|GTTGTTGAGTTGCAAACTTCAAGTATCACA
GCCCACGGTGGCGGCCATACCGTGTGAGGA|TCACCTTCCGTGTGAGGAGATGTGACCATA
ATGTGACCATAAGAATTGGTAAGCTTCCGG|AAGAATTGATGTGTACTGCGCCTGTGCATC
GTAACCGTGTGAGGAGATGTGACCATAAGA|AGGCTGGGTATGGTATGCCCACGGTGGCGG
TTGGAAATTCCGTGTGAGGAGATGTGACCA|TGGCTCCTATAAAAATGAGGGGATTTGGCC
TTGATCCGTGTGAGGAGATGTGACCATAAG|TAAATGGTTATCAGCGGACCGCAATTCGAT
ATGTGACCATAAGAATTGAGACACTCCGGT|GGAGATGTGACCATAAGAATTGGTAAGCTT
CCGTCGTGTCGTGTTGACCGTATGAAAGGA|CGGGTCCATCAAACTAAGACTGCGCTATCC
TACCGTGTGAGGAGATGTGACCATAAGAAT|CCATAAGAATTGGCCGGCGTTCGTTGTTGA
ACCATAAGAATTGGTCGAGCGATAGGGGCC|GAGGAGATGTGACCATAAGAATTGACCAAC
GGGTATTCCGTGTGAGGAGATGTGACCATA|TGACCATAAGAATTGGTGAGGAGATGTGAC
CTTTAAATGCCCAGGGAGCCGGCGTGTACC|GGAGATGTGACCATAAGAATTGCAGCTAAC
ATGTGACCACCGTGTGAGGAGATGTGACCA|GAATTGCTTACCAATGACACCGTGATCCCG
GGTGAGGAGATGTGACCATAAGAATTGGTA|AAGAATTGTAAGAATTGATGTGTACTGCGC
TCCTGTGGTGCAATAGCGTCCTTTCAACGA|CTCCGGTAGAATTATCACTTTTATGTAACC
TGGCCGTCGTGTCGTGTTGACCGTATGAAA|CCCCGGGTCCATCAAACTAAGACTGCGCTA
TACGGCAACGCTATATGGGCAGGGTATTCC|TACCGTCCGTGTGAGGAGATGTGACCATAA
GTGAGGAGATGTGACCATAAGAATTGTTTG|GAATTGGCCGGCGTTCGTTGTTGAGTTGCA
TAAGAAGGGGACCCCGGGTCCATCAAACTA|ATTGTACCAAATCAGTACCACCAAGATTTG
ACCGTATGAAAGGAGTAGTAGGGGTGTGGG|AGACTGCGCTATCCGGTTCCTTTTCGCACC
GTGTTGACCGTATGAAAGGAGTAGTAGGGG|AAACTAAGACTGCGCTATCCGGTTCCTTTT
AAATGCCCAGGGAGCCGGCGTGTACCATAC|ATGTGACCATAAGAATTGCAGCTAACTTAC
GTCCTCGATTTCACCTTCCGTGTGAGGAGA|CGTACACGACTGTTATGCTGCACTGCGCAA
AGGCCACTGATTTCTCTGTGTAGCCTGAGG|GGGGTAAAGAGATGAGCAGGCGTACCGTGT
CACAGAGTGAAACGTACACGACTGTTATGC|AGCTGTTAGATACGTTTTGAGAAAGGCCAC
CATAAGAATTGTAAGAATTGATGTGTACTG|CGTGTGAGGAGATGTGACCATAAGAATTGA
AGCCGGCGTGTACCATACGGCAACGCTATA|GAATTGCAGCTAACTTACCGTCCGTGTGAG
AGAGATGAGCAGGCGTACCGTGTGAGGAGA|TGTGAGGAGATGTGACCATAAGAATTGGCC
AGACACTCCGGTAGAATTATCACTTTTATG|ATTGGTAAGCTTCCGGATCCGATTATAATA
TTTTATGTAACCGTGTGAGGAGATGTGACC|TATAATAGGCTGGGTATGGTATGCCCACGG
GGGCCATCGCAACGGTATTCGCGTTCAGAG|CCAACTGGCGCCGCGCGTGTTCGTTGGCTT
GGGCCCGTGTGAGGAGATGTGACCATAAGA|GGGTTGGAAATTCCGTGTGAGGAGATGTGA
TATTCGCGTTCAGAGAGGACTAGACTTAGG|CGTGTTCGTTGGCTTAGATCTGTTTTTTCC
TGACCATAAGAATTGAGACACTCCGGTAGA|GATGTGACCATAAGAATTGGTAAGCTTCCG
GGAGAACGACATGGGTTGGAAATTCCGTGT|CCTAGCTGTAACGGGTGGCTCCTATAAAAA
AGAGGCCATCTCAAACTTGCAGACATCTTA|GTTTTTGTCCAATGGTACGAATGGCCGTCG
TGACCATAAGAATTGAGACATAGACATTGC|CTCAAACTTGCAGACATCTTACCCGTTCAA
GAGGAGATGTGACCATAAGAATTGGTGAGG|ACCGTGTGAGGAGATGTGACCATAAGAATT
AAACTTCAAGTATCACATTGTACCAAATCA|AACGGTATTCGCGTTCAGAGAGGACTAGAC
TTGAGAAAGGCCACTGATTTCTCTGTGTAG|GGGGTGTGGGGTAAAGAGATGAGCAGGCGT
GACCAACTGGCGCCGCGCGTGTTCGTTGGC|AGGGATGTCGTCTCTCAGCCGTATGATAAG
GTGAGGAGATGTGACCATAAGAATTGACCA|ATCAGCGGACCGCAATTCGATTCTGAGGGA
GTGAGGAGATGTGACCATAAGAATTGGTAA|AGAATTGTAAGAATTGATGTGTACTGCGCC
GTGAGGAGATGTGACCATAAGAATTGATCC|AATGAGGGGATTTGGCCAATCACTAAATGG
GTATGGTATGCCCACGGTGGCGGCCATACC|TCCTCGATTTCACCTTCCGTGTGAGGAGAT
AACGTACACGACTGTTATGCTGCACTGCGC|TACGTTTTGAGAAAGGCCACTGATTTCTCT
TCAAACTTGCAGACATCTTACCCGTTCAAT|AATGGTACGAATGGCCGTCGTGTCGTGTTG
GAACGACATGGGTTGGAAATTCCGTGTGAG|AGCTGTAACGGGTGGCTCCTATAAAAATGA
GACATTGCCAACACACAGAGTGAAACGTAC|CCGTTCAATCAGTAGCTGTTAGATACGTTT
TGCCCACGGTGGCGGCCATACCGTGTGAGG|TTCACCTTCCGTGTGAGGAGATGTGACCAT
GTGACCATAAGAATTGGTAAGCTTCCGGAT|GAATTGATGTGTACTGCGCCTGTGCATCTG
TTCGCACCACCGTGTGAGGAGATGTGACCA|CATAAGAATTCCGTGTGAGGAGATGTGACC
CGTGTGAGGAGATGTGACCACCGTGTGAGG|TGTGACCATAAGAATTGCTTACCAATGACA
CATAAGAATTGGTGAGGAGATGTGACCATA|ATGTGACCATAAGAATTGTAAGAATTGATG
ACACCGTGATCCCGTGTGAGGAGATGTGAC|GCGAGAGCGGTGATAAGAGAGGCCATCTCA
GGCCATACCGTGTGAGGAGATGTGACCACC|TGAGGAGATGTGACCATAAGAATTGCTTAC
CGCCTGTGCATCTGGGTTGTCGATCAGTGC|GACATAGACATTGCCAACACACAGAGTGAA
TGACCATAAGAATTGGCCGGCGTTCGTTGT|GTGACCATAAGAATTGGTCGAGCGATAGGG
CACTCCGGTAGAATTATCACTTTTATGTAA|GGTAAGCTTCCGGATCCGATTATAATAGGC
AATTCCGTGTGAGGAGATGTGACCATAAGA|ACCATAAGAATTGATCCGTGTGAGGAGATG
AGAAGGGGACCCCGGGTCCATCAAACTAAG|TGTACCAAATCAGTACCACCAAGATTTGGG
TGTGACCATAAGAATTGAGACACTCCGGTA|GAGATGTGACCATAAGAATTGGTAAGCTTC
GAAATTCCGTGTGAGGAGATGTGACCATAA|CTCCTATAAAAATGAGGGGATTTGGCCAAT
CAGTACCACCAAGATTTGGGCCCGTGTGAG|ACTTAGGAGAACGACATGGGTTGGAAATTC
CGAAAGCGAGAGCGGTGATAAGAGAGGCCA|GATGTGACCATAAGAATTGTGCGTTTTTGT
CTCAAACTTGCAGACATCTTACCCGTTCAA|CAATGGTACGAATGGCCGTCGTGTCGTGTT
GGGGTGTGGGGTAAAGAGATGAGCAGGCGT|TTTTCGCACCACCGTGTGAGGAGATGTGAC
GTAGCTGTTAGATACGTTTTGAGAAAGGCC|CGTATGAAAGGAGTAGTAGGGGTGTGGGGT
AGATGTGACCATAAGAATTGGTAAGCTTCC|GTAAGAATTGATGTGTACTGCGCCTGTGCA
ATTCCGTGTGAGGAGATGTGACCATAAGAA|CTATAAAAATGAGGGGATTTGGCCAATCAC
TCAGCCTTTGACGACCGCGAAAGCGAGAGC|CTGAGGCCGTGTGAGGAGATGTGACCATAA
GATGTGACCATAAGAATTGTAAGAATTGAT|CGTGATCCCGTGTGAGGAGATGTGACCATA
CATAAGAATTGCAGCTAACTTACCGTCCGT|GTGGCGGCCATACCGTGTGAGGAGATGTGA
TTGGTAAGCTTCCGGATCCGATTATAATAG|CTGCGCCTGTGCATCTGGGTTGTCGATCAG
TTTTGAGAAAGGCCACTGATTTCTCTGTGT|TAGGGGTGTGGGGTAAAGAGATGAGCAGGC
TACGTTTTGAGAAAGGCCACTGATTTCTCT|GTAGTAGGGGTGTGGGGTAAAGAGATGAGC
CCAATGGTACGAATGGCCGTCGTGTCGTGT|AGTAAGAAGGGGACCCCGGGTCCATCAAAC
CTTACCCGTTCAATCAGTAGCTGTTAGATA|GTCGTGTCGTGTTGACCGTATGAAAGGAGT
TGTGGTGCAATAGCGTCCTTTCAACGAATC|CGGTAGAATTATCACTTTTATGTAACCGTG
TTATAATAGGCTGGGTATGGTATGCCCACG|GTCGATCAGTGCCGTCCTCGATTTCACCTT
GCAACGCTATATGGGCAGGGTATTCCGTGT|GTCCGTGTGAGGAGATGTGACCATAAGAAT
GTGCCGTCCTCGATTTCACCTTCCGTGTGA|TGAAACGTACACGACTGTTATGCTGCACTG
ATATGGGCAGGGTATTCCGTGTGAGGAGAT|GAGGAGATGTGACCATAAGAATTGGTGAGG
TCGCGTTCAGAGAGGACTAGACTTAGGAGA|GTTCGTTGGCTTAGATCTGTTTTTTCCTAG
CAATGGTACGAATGGCCGTCGTGTCGTGTT|GTAAGAAGGGGACCCCGGGTCCATCAAACT
CGTGTTGACCGTATGAAAGGAGTAGTAGGG|CAAACTAAGACTGCGCTATCCGGTTCCTTT
AATAGCGTCCTTTCAACGAATCAATCTTTA|TTATCACTTTTATGTAACCGTGTGAGGAGA
GGCCACTGATTTCTCTGTGTAGCCTGAGGC|GGGTAAAGAGATGAGCAGGCGTACCGTGTG
AGATGTGACCATAAGAATTGCTTACCAATG|CAACTTTGTCAGCCTTTGACGACCGCGAAA
GCCAACACACAGAGTGAAACGTACACGACT|AATCAGTAGCTGTTAGATACGTTTTGAGAA
ATGCCCACGGTGGCGGCCATACCGTGTGAG|TTTCACCTTCCGTGTGAGGAGATGTGACCA
GGTAAGCTTCCGGATCCGATTATAATAGGC|GCGCCTGTGCATCTGGGTTGTCGATCAGTG
AATTGGCCGGCGTTCGTTGTTGAGTTGCAA|GAATTGGTCGAGCGATAGGGGCCATCGCAA
CGAATCAATCTTTAAATGCCCAGGGAGCCG|ACCGTGTGAGGAGATGTGACCATAAGAATT
CTTTGACGACCGCGAAAGCGAGAGCGGTGA|GCCGTGTGAGGAGATGTGACCATAAGAATT
TTAGGAGAACGACATGGGTTGGAAATTCCG|TTTCCTAGCTGTAACGGGTGGCTCCTATAA
TGTGACCATAAGAATTGTTTGAGCTTCCAG|GGCGTTCGTTGTTGAGTTGCAAACTTCAAG
ATTGGCCGGCGTTCGTTGTTGAGTTGCAAA|AATTGGTCGAGCGATAGGGGCCATCGCAAC
GACACTCCGGTAGAATTATCACTTTTATGT|TTGGTAAGCTTCCGGATCCGATTATAATAG
TGAGCTTCCAGGACCAGTAAGAAGGGGACC|CAAACTTCAAGTATCACATTGTACCAAATC
GCACCACCGTGTGAGGAGATGTGACCATAA|AAGAATTCCGTGTGAGGAGATGTGACCATA
GTGACCATAAGAATTGTAAGAATTGATGTG|GATCCCGTGTGAGGAGATGTGACCATAAGA
AGAATTGGTCGAGCGATAGGGGCCATCGCA|ATGTGACCATAAGAATTGACCAACTGGCGC
AATCAGTACCACCAAGATTTGGGCCCGTGT|TAGACTTAGGAGAACGACATGGGTTGGAAA
TGGGCAGGGTATTCCGTGTGAGGAGATGTG|GAGATGTGACCATAAGAATTGGTGAGGAGA
AGAATTATCACTTTTATGTAACCGTGTGAG|CCGGATCCGATTATAATAGGCTGGGTATGG
AGTAAGAAGGGGACCCCGGGTCCATCAAAC|ACATTGTACCAAATCAGTACCACCAAGATT
GCCTTTGACGACCGCGAAAGCGAGAGCGGT|AGGCCGTGTGAGGAGATGTGACCATAAGAA
TTGCTTACCAATGACACCGTGATCCCGTGT|GACGACCGCGAAAGCGAGAGCGGTGATAAG
ACTCCGGTAGAATTATCACTTTTATGTAAC|GTAAGCTTCCGGATCCGATTATAATAGGCT
GTGTGGGGTAAAGAGATGAGCAGGCGTACC|TCGCACCACCGTGTGAGGAGATGTGACCAT
AAAGGCCACTGATTTCTCTGTGTAGCCTGA|GTGGGGTAAAGAGATGAGCAGGCGTACCGT
ATGTGAATCCCTAGCGTTTTTTCCTGTGGT|GTGACCATAAGAATTGAGACACTCCGGTAG
CTGGCGCCGCGCGTGTTCGTTGGCTTAGAT|GTCGTCTCTCAGCCGTATGATAAGAAGCCG
TAGCCTGAGGCCGTGTGAGGAGATGTGACC|CGTACCGTGTGAGGAGATGTGACCATAAGA
CCACCAAGATTTGGGCCCGTGTGAGGAGAT|GGAGAACGACATGGGTTGGAAATTCCGTGT
ACCGTGTGAGGAGATGTGACCATAAGAATT|CATAAGAATTGGCCGGCGTTCGTTGTTGAG
CCGTTCAATCAGTAGCTGTTAGATACGTTT|GTCGTGTTGACCGTATGAAAGGAGTAGTAG
AATGCCCAGGGAGCCGGCGTGTACCATACG|TGTGACCATAAGAATTGCAGCTAACTTACC
GCGGCCATACCGTGTGAGGAGATGTGACCA|TGTGAGGAGATGTGACCATAAGAATTGCTT
CCATCAAACTAAGACTGCGCTATCCGGTTC|ACCAAGATTTGGGCCCGTGTGAGGAGATGT
GACACCGTGATCCCGTGTGAGGAGATGTGA|AGCGAGAGCGGTGATAAGAGAGGCCATCTC
GTGAAACGTACACGACTGTTATGCTGCACT|TAGATACGTTTTGAGAAAGGCCACTGATTT
GCTTCCAGGACCAGTAAGAAGGGGACCCCG|ACTTCAAGTATCACATTGTACCAAATCAGT
TTGTCAGCCTTTGACGACCGCGAAAGCGAG|AGCCTGAGGCCGTGTGAGGAGATGTGACCA
TAGGGGCCATCGCAACGGTATTCGCGTTCA|TGACCAACTGGCGCCGCGCGTGTTCGTTGG
GCGGTGATAAGAGAGGCCATCTCAAACTTG|AAGAATTGTGCGTTTTTGTCCAATGGTACG
CCGTGTGAGGAGATGTGACCATAAGAATTG|TGGGTATGGTATGCCCACGGTGGCGGCCAT
AACGCTATATGGGCAGGGTATTCCGTGTGA|CCGTGTGAGGAGATGTGACCATAAGAATTG
AATGTGAATCCCTAGCGTTTTTTCCTGTGG|TGTGACCATAAGAATTGAGACACTCCGGTA
TGTGACCACCGTGTGAGGAGATGTGACCAT|AATTGCTTACCAATGACACCGTGATCCCGT
TTGTTGAGTTGCAAACTTCAAGTATCACAT|AGGGGCCATCGCAACGGTATTCGCGTTCAG
GTTATGCTGCACTGCGCAACTTTGTCAGCC|AGGCCACTGATTTCTCTGTGTAGCCTGAGG
TGAGCAGGCGTACCGTGTGAGGAGATGTGA|GGAGATGTGACCATAAGAATTGGCCGGCGT
CCGTGTGAGGAGATGTGACCACCGTGTGAG|ATGTGACCATAAGAATTGCTTACCAATGAC
AGATGTGACCATAAGAATTGTAAGAATTGA|CCGTGATCCCGTGTGAGGAGATGTGACCAT
TGAGGAGATGTGACCATAAGAATTGTGCGT|GATGTGACCATAAGAATTGTTTGAGCTTCC
CACGACTGTTATGCTGCACTGCGCAACTTT|TTGAGAAAGGCCACTGATTTCTCTGTGTAG
TATGCTGCACTGCGCAACTTTGTCAGCCTT|GCCACTGATTTCTCTGTGTAGCCTGAGGCC
TCGCAACGGTATTCGCGTTCAGAGAGGACT|GGCGCCGCGCGTGTTCGTTGGCTTAGATCT
GAATTGCAGCTAACTTACCGTCCGTGTGAG|GGCCATACCGTGTGAGGAGATGTGACCACC
TGCTGCACTGCGCAACTTTGTCAGCCTTTG|CACTGATTTCTCTGTGTAGCCTGAGGCCGT
TGACCAACTGGCGCCGCGCGTGTTCGTTGG|GAGGGATGTCGTCTCTCAGCCGTATGATAA
AAACTTGCAGACATCTTACCCGTTCAATCA|TGGTACGAATGGCCGTCGTGTCGTGTTGAC
GCAACTTTGTCAGCCTTTGACGACCGCGAA|CTGTGTAGCCTGAGGCCGTGTGAGGAGATG
CCGTGTGAGGAGATGTGACCATAAGAATTG|TAAAAATGAGGGGATTTGGCCAATCACTAA
GGGTTGTCGATCAGTGCCGTCCTCGATTTC|CCAACACACAGAGTGAAACGTACACGACTG
GGCGCCGCGCGTGTTCGTTGGCTTAGATCT|CGTCTCTCAGCCGTATGATAAGAAGCCGTG
AGTATCACATTGTACCAAATCAGTACCACC|TCGCGTTCAGAGAGGACTAGACTTAGGAGA
CCGGTAGAATTATCACTTTTATGTAACCGT|AGCTTCCGGATCCGATTATAATAGGCTGGG
TGTGAGGAGATGTGACCATAAGAATTGGCC|GTGTGAGGAGATGTGACCATAAGAATTGGT
ATCTGGGTTGTCGATCAGTGCCGTCCTCGA|ATTGCCAACACACAGAGTGAAACGTACACG
GTTCAATCAGTAGCTGTTAGATACGTTTTG|CGTGTTGACCGTATGAAAGGAGTAGTAGGG
CTTCAAGTATCACATTGTACCAAATCAGTA|GGTATTCGCGTTCAGAGAGGACTAGACTTA
AAGAATTGTGCGTTTTTGTCCAATGGTACG|TGTTTGAGCTTCCAGGACCAGTAAGAAGGG
GTAAGAAGGGGACCCCGGGTCCATCAAACT|CATTGTACCAAATCAGTACCACCAAGATTT
GTGGGGTAAAGAGATGAGCAGGCGTACCGT|GCACCACCGTGTGAGGAGATGTGACCATAA
CGGGTCCATCAAACTAAGACTGCGCTATCC|GTACCACCAAGATTTGGGCCCGTGTGAGGA
ACATTGTACCAAATCAGTACCACCAAGATT|TCAGAGAGGACTAGACTTAGGAGAACGACA
CCAACACACAGAGTGAAACGTACACGACTG|ATCAGTAGCTGTTAGATACGTTTTGAGAAA
GTGTGAGGAGATGTGACCATAAGAATTGGC|CGTGTGAGGAGATGTGACCATAAGAATTGG
GTGTGAGGAGATGTGACCATAAGAATTGCT|GCACTGCGCAACTTTGTCAGCCTTTGACGA
ACCATAAGAATTGTTTGAGCTTCCAGGACC|TTCGTTGTTGAGTTGCAAACTTCAAGTATC
ATGTGACCATAAGAATTGAGACATAGACAT|CATCTCAAACTTGCAGACATCTTACCCGTT
TTCCGTGTGAGGAGATGTGACCATAAGAAT|TATAAAAATGAGGGGATTTGGCCAATCACT
CATGGGTTGGAAATTCCGTGTGAGGAGATG|AACGGGTGGCTCCTATAAAAATGAGGGGAT
GTACGAATGGCCGTCGTGTCGTGTTGACCG|AAGGGGACCCCGGGTCCATCAAACTAAGAC
AAGATTTGGGCCCGTGTGAGGAGATGTGAC|ACGACATGGGTTGGAAATTCCGTGTGAGGA
CGCTATATGGGCAGGGTATTCCGTGTGAGG|GTGTGAGGAGATGTGACCATAAGAATTGGT
TGTGAGGAGATGTGACCATAAGAATTGTTT|AGAATTGGCCGGCGTTCGTTGTTGAGTTGC
CGTGTGAGGAGATGTGACCATAAGAATTGT|CCAATGACACCGTGATCCCGTGTGAGGAGA
TGACCATAAGAATTCCGTGTGAGGAGATGT|AGGAGATGTGACCATAAGAATTGATCCGTG
TGTGAGGAGATGTGACCATAAGAATTGTGC|GAGATGTGACCATAAGAATTGTTTGAGCTT
GAGCGATAGGGGCCATCGCAACGGTATTCG|AAGAATTGACCAACTGGCGCCGCGCGTGTT
CACTGCGCAACTTTGTCAGCCTTTGACGAC|ATTTCTCTGTGTAGCCTGAGGCCGTGTGAG
ATCTCAAACTTGCAGACATCTTACCCGTTC|TCCAATGGTACGAATGGCCGTCGTGTCGTG
TGACCATAAGAATTGTGCGTTTTTGTCCAA|TAAGAATTGTTTGAGCTTCCAGGACCAGTA
TCCCTAGCGTTTTTTCCTGTGGTGCAATAG|TAAGAATTGAGACACTCCGGTAGAATTATC
GAGATGTGACCATAAGAATTGTGCGTTTTT|TGACCATAAGAATTGTTTGAGCTTCCAGGA
GAGGAGATGTGACCATAAGAATTCCGTGTG|TTCCGTGTGAGGAGATGTGACCATAAGAAT
TGACCACCGTGTGAGGAGATGTGACCATAA|TTGCTTACCAATGACACCGTGATCCCGTGT
TGTGAGGAGATGTGACCATAAGAATTGAGA|AAGAGAGGCCATCTCAAACTTGCAGACATC
GAGATGTGACCATAAGAATTGGTCGAGCGA|ATCCGTGTGAGGAGATGTGACCATAAGAAT
GCAGACATCTTACCCGTTCAATCAGTAGCT|GAATGGCCGTCGTGTCGTGTTGACCGTATG
TGGCGCCGCGCGTGTTCGTTGGCTTAGATC|TCGTCTCTCAGCCGTATGATAAGAAGCCGT
CCATACCGTGTGAGGAGATGTGACCACCGT|AGGAGATGTGACCATAAGAATTGCTTACCA
AGAATTGAGACATAGACATTGCCAACACAC|TGCAGACATCTTACCCGTTCAATCAGTAGC
TTTTTGTCCAATGGTACGAATGGCCGTCGT|CAGGACCAGTAAGAAGGGGACCCCGGGTCC
CCCTAGCGTTTTTTCCTGTGGTGCAATAGC|AAGAATTGAGACACTCCGGTAGAATTATCA
CCATAAGAATTGCAGCTAACTTACCGTCCG|GGTGGCGGCCATACCGTGTGAGGAGATGTG
GTGTAGCCTGAGGCCGTGTGAGGAGATGTG|AGGCGTACCGTGTGAGGAGATGTGACCATA
CAGAGAGGACTAGACTTAGGAGAACGACAT|GGCTTAGATCTGTTTTTTCCTAGCTGTAAC
ACCATAAGAATTGTAAGAATTGATGTGTAC|CCCGTGTGAGGAGATGTGACCATAAGAATT
CACCGTGTGAGGAGATGTGACCATAAGAAT|ATTCCGTGTGAGGAGATGTGACCATAAGAA
TATATGGGCAGGGTATTCCGTGTGAGGAGA|TGAGGAGATGTGACCATAAGAATTGGTGAG
CGAGAGCGGTGATAAGAGAGGCCATCTCAA|ACCATAAGAATTGTGCGTTTTTGTCCAATG
AGCAGGCGTACCGTGTGAGGAGATGTGACC|AGATGTGACCATAAGAATTGGCCGGCGTTC
CCGGCGTGTACCATACGGCAACGCTATATG|ATTGCAGCTAACTTACCGTCCGTGTGAGGA
GTGAGGAGATGTGACCATAAGAATTGGTCG|AATTGATCCGTGTGAGGAGATGTGACCATA
GAGATGTGACCATAAGAATTGGCCGGCGTT|GGAGATGTGACCATAAGAATTGGTCGAGCG
GTAGAATTATCACTTTTATGTAACCGTGTG|TTCCGGATCCGATTATAATAGGCTGGGTAT
CGAGCGATAGGGGCCATCGCAACGGTATTC|TAAGAATTGACCAACTGGCGCCGCGCGTGT
CCATAAGAATTGAGACATAGACATTGCCAA|AAACTTGCAGACATCTTACCCGTTCAATCA
ATTGGTGAGGAGATGTGACCATAAGAATTG|CATAAGAATTGTAAGAATTGATGTGTACTG
TGTCAGCCTTTGACGACCGCGAAAGCGAGA|GCCTGAGGCCGTGTGAGGAGATGTGACCAT
CATAAGAATTGGTAAGCTTCCGGATCCGAT|GATGTGTACTGCGCCTGTGCATCTGGGTTG
ATAAGAATTGGCCGGCGTTCGTTGTTGAGT|CATAAGAATTGGTCGAGCGATAGGGGCCAT
ATAGGGGCCATCGCAACGGTATTCGCGTTC|TTGACCAACTGGCGCCGCGCGTGTTCGTTG
GTATTCCGTGTGAGGAGATGTGACCATAAG|ACCATAAGAATTGGTGAGGAGATGTGACCA
TGTGAGGAGATGTGACCATAAGAATTGCAG|GTATGGTATGCCCACGGTGGCGGCCATACC
ACTGGCGCCGCGCGTGTTCGTTGGCTTAGA|TGTCGTCTCTCAGCCGTATGATAAGAAGCC
GACCATAAGAATTGCAGCTAACTTACCGTC|ACGGTGGCGGCCATACCGTGTGAGGAGATG
CGTGTACCATACGGCAACGCTATATGGGCA|CAGCTAACTTACCGTCCGTGTGAGGAGATG
AGATGTGACCACCGTGTGAGGAGATGTGAC|AAGAATTGCTTACCAATGACACCGTGATCC
GATGTGACCATAAGAATTGGCCGGCGTTCG|AGATGTGACCATAAGAATTGGTCGAGCGAT
CCCGTGTGAGGAGATGTGACCATAAGAATT|TTGGAAATTCCGTGTGAGGAGATGTGACCA
GACTGTTATGCTGCACTGCGCAACTTTGTC|AGAAAGGCCACTGATTTCTCTGTGTAGCCT
GGGTAAAGAGATGAGCAGGCGTACCGTGTG|CCACCGTGTGAGGAGATGTGACCATAAGAA
GACCATAAGAATTGGCCGGCGTTCGTTGTT|TGACCATAAGAATTGGTCGAGCGATAGGGG
GAGGAGATGTGACCATAAGAATTGTGCGTT|ATGTGACCATAAGAATTGTTTGAGCTTCCA
TGCCAACACACAGAGTGAAACGTACACGAC|CAATCAGTAGCTGTTAGATACGTTTTGAGA
TAAGAATTGTTTGAGCTTCCAGGACCAGTA|TTGTTGAGTTGCAAACTTCAAGTATCACAT
CACCGTGATCCCGTGTGAGGAGATGTGACC|CGAGAGCGGTGATAAGAGAGGCCATCTCAA
GAAGGGGACCCCGGGTCCATCAAACTAAGA|GTACCAAATCAGTACCACCAAGATTTGGGC
CGACCGCGAAAGCGAGAGCGGTGATAAGAG|TGAGGAGATGTGACCATAAGAATTGTGCGT
CATTGCCAACACACAGAGTGAAACGTACAC|GTTCAATCAGTAGCTGTTAGATACGTTTTG
GTCCAATGGTACGAATGGCCGTCGTGTCGT|CCAGTAAGAAGGGGACCCCGGGTCCATCAA
TCTTTAAATGCCCAGGGAGCCGGCGTGTAC|AGGAGATGTGACCATAAGAATTGCAGCTAA
AATAGGCTGGGTATGGTATGCCCACGGTGG|ATCAGTGCCGTCCTCGATTTCACCTTCCGT
GTGTCGTGTTGACCGTATGAAAGGAGTAGT|CCATCAAACTAAGACTGCGCTATCCGGTTC
CGTGTGAGGAGATGTGACCATAAGAATTGG|AAGAATTGATCCGTGTGAGGAGATGTGACC
CGGTATTCGCGTTCAGAGAGGACTAGACTT|GCGCGTGTTCGTTGGCTTAGATCTGTTTTT
TACCATACGGCAACGCTATATGGGCAGGGT|TAACTTACCGTCCGTGTGAGGAGATGTGAC
GTTTTGAGAAAGGCCACTGATTTCTCTGTG|GTAGGGGTGTGGGGTAAAGAGATGAGCAGG
TCAATCTTTAAATGCCCAGGGAGCCGGCGT|TGTGAGGAGATGTGACCATAAGAATTGCAG
AGGCGTACCGTGTGAGGAGATGTGACCATA|TGTGACCATAAGAATTGGCCGGCGTTCGTT
GAGGAGATGTGACCATAAGAATTGAGACAC|TGGTGAGGAGATGTGACCATAAGAATTGGT
ACGTACACGACTGTTATGCTGCACTGCGCA|ACGTTTTGAGAAAGGCCACTGATTTCTCTG
CAACGCTATATGGGCAGGGTATTCCGTGTG|TCCGTGTGAGGAGATGTGACCATAAGAATT
AGACATCTTACCCGTTCAATCAGTAGCTGT|ATGGCCGTCGTGTCGTGTTGACCGTATGAA
AGGAGATGTGACCATAAGAATTGTGCGTTT|TGTGACCATAAGAATTGTTTGAGCTTCCAG
CAACTTTGTCAGCCTTTGACGACCGCGAAA|TGTGTAGCCTGAGGCCGTGTGAGGAGATGT
GTGTGAGGAGATGTGACCATAAGAATTGTG|GGAGATGTGACCATAAGAATTGTTTGAGCT
TTGTCGATCAGTGCCGTCCTCGATTTCACC|ACACACAGAGTGAAACGTACACGACTGTTA
ATAATAGGCTGGGTATGGTATGCCCACGGT|CGATCAGTGCCGTCCTCGATTTCACCTTCC
TGAGGAGATGTGACCATAAGAATTCCGTGT|ATTCCGTGTGAGGAGATGTGACCATAAGAA
ACTTCAAGTATCACATTGTACCAAATCAGT|CGGTATTCGCGTTCAGAGAGGACTAGACTT
GTCGATCAGTGCCGTCCTCGATTTCACCTT|ACACAGAGTGAAACGTACACGACTGTTATG
TGGCGGCCATACCGTGTGAGGAGATGTGAC|CGTGTGAGGAGATGTGACCATAAGAATTGC
ATCACATTGTACCAAATCAGTACCACCAAG|CGTTCAGAGAGGACTAGACTTAGGAGAACG
GATCCGTGTGAGGAGATGTGACCATAAGAA|AATGGTTATCAGCGGACCGCAATTCGATTC
CGTGTGAGGAGATGTGACCATAAGAATTGA|AGAATTGGTGAGGAGATGTGACCATAAGAA
GTTGACCGTATGAAAGGAGTAGTAGGGGTG|ACTAAGACTGCGCTATCCGGTTCCTTTTCG
AGGAGATGTGACCACCGTGTGAGGAGATGT|CATAAGAATTGCTTACCAATGACACCGTGA
GTCCGTGTGAGGAGATGTGACCATAAGAAT|ATGTGACCACCGTGTGAGGAGATGTGACCA
GGGTTGGAAATTCCGTGTGAGGAGATGTGA|GGGTGGCTCCTATAAAAATGAGGGGATTTG
GATGTGACCATAAGAATTGCAGCTAACTTA|TGCCCACGGTGGCGGCCATACCGTGTGAGG
ACGTTTTGAGAAAGGCCACTGATTTCTCTG|TAGTAGGGGTGTGGGGTAAAGAGATGAGCA
TGAGGAGATGTGACCATAAGAATTGCTTAC|CTGCGCAACTTTGTCAGCCTTTGACGACCG
GGAAATTCCGTGTGAGGAGATGTGACCATA|GCTCCTATAAAAATGAGGGGATTTGGCCAA
TGGGTATGGTATGCCCACGGTGGCGGCCAT|CCGTCCTCGATTTCACCTTCCGTGTGAGGA
CCATAAGAATTGGTAAGCTTCCGGATCCGA|TGATGTGTACTGCGCCTGTGCATCTGGGTT
GTTGTCGATCAGTGCCGTCCTCGATTTCAC|AACACACAGAGTGAAACGTACACGACTGTT
TTGAGCTTCCAGGACCAGTAAGAAGGGGAC|GCAAACTTCAAGTATCACATTGTACCAAAT
ATAGCGTCCTTTCAACGAATCAATCTTTAA|TATCACTTTTATGTAACCGTGTGAGGAGAT
TGGTCGAGCGATAGGGGCCATCGCAACGGT|ACCATAAGAATTGACCAACTGGCGCCGCGC
CCATAAGAATTGTGCGTTTTTGTCCAATGG|GAATTGTTTGAGCTTCCAGGACCAGTAAGA
TGACGACCGCGAAAGCGAGAGCGGTGATAA|GTGTGAGGAGATGTGACCATAAGAATTGTG
AGGGGCCATCGCAACGGTATTCGCGTTCAG|GACCAACTGGCGCCGCGCGTGTTCGTTGGC
TCCGATTATAATAGGCTGGGTATGGTATGC|GGGTTGTCGATCAGTGCCGTCCTCGATTTC
TGCAGACATCTTACCCGTTCAATCAGTAGC|CGAATGGCCGTCGTGTCGTGTTGACCGTAT
TTGAGTTGCAAACTTCAAGTATCACATTGT|GGCCATCGCAACGGTATTCGCGTTCAGAGA
GTACCAAATCAGTACCACCAAGATTTGGGC|GAGGACTAGACTTAGGAGAACGACATGGGT
ACAGAGTGAAACGTACACGACTGTTATGCT|GCTGTTAGATACGTTTTGAGAAAGGCCACT
CCGGATCCGATTATAATAGGCTGGGTATGG|CATCTGGGTTGTCGATCAGTGCCGTCCTCG
ACTGCGCCTGTGCATCTGGGTTGTCGATCA|TTGAGACATAGACATTGCCAACACACAGAG
CATAAGAATTGCTTACCAATGACACCGTGA|CAGCCTTTGACGACCGCGAAAGCGAGAGCG
TATTCCGTGTGAGGAGATGTGACCATAAGA|CCATAAGAATTGGTGAGGAGATGTGACCAT
CTAAGACTGCGCTATCCGGTTCCTTTTCGC|TTGGGCCCGTGTGAGGAGATGTGACCATAA
GCCTGAGGCCGTGTGAGGAGATGTGACCAT|TACCGTGTGAGGAGATGTGACCATAAGAAT
ACTTTGTCAGCCTTTGACGACCGCGAAAGC|TGTAGCCTGAGGCCGTGTGAGGAGATGTGA
CTGGGTTGTCGATCAGTGCCGTCCTCGATT|TGCCAACACACAGAGTGAAACGTACACGAC
GTTGCAAACTTCAAGTATCACATTGTACCA|ATCGCAACGGTATTCGCGTTCAGAGAGGAC
TCCAGGACCAGTAAGAAGGGGACCCCGGGT|TCAAGTATCACATTGTACCAAATCAGTACC
GAGGAGATGTGACCATAAGAATTGTTTGAG|ATTGGCCGGCGTTCGTTGTTGAGTTGCAAA
GCTGTTAGATACGTTTTGAGAAAGGCCACT|ATGAAAGGAGTAGTAGGGGTGTGGGGTAAA
AGTACCACCAAGATTTGGGCCCGTGTGAGG|CTTAGGAGAACGACATGGGTTGGAAATTCC
AATTATCACTTTTATGTAACCGTGTGAGGA|GGATCCGATTATAATAGGCTGGGTATGGTA
TTACCGTCCGTGTGAGGAGATGTGACCATA|AGGAGATGTGACCACCGTGTGAGGAGATGT
GCCGGCGTTCGTTGTTGAGTTGCAAACTTC|GGTCGAGCGATAGGGGCCATCGCAACGGTA
ACTTACCGTCCGTGTGAGGAGATGTGACCA|TGAGGAGATGTGACCACCGTGTGAGGAGAT
GGGGCCATCGCAACGGTATTCGCGTTCAGA|ACCAACTGGCGCCGCGCGTGTTCGTTGGCT
CGTCCTCGATTTCACCTTCCGTGTGAGGAG|ACGTACACGACTGTTATGCTGCACTGCGCA
TGAGTTGCAAACTTCAAGTATCACATTGTA|GCCATCGCAACGGTATTCGCGTTCAGAGAG
GTGACCATAAGAATTGGCCGGCGTTCGTTG|TGTGACCATAAGAATTGGTCGAGCGATAGG
TTCCGTGTGAGGAGATGTGACCATAAGAAT|CATAAGAATTGATCCGTGTGAGGAGATGTG
AAGAATTGCTTACCAATGACACCGTGATCC|CCTTTGACGACCGCGAAAGCGAGAGCGGTG
CTAGCGTTTTTTCCTGTGGTGCAATAGCGT|GAATTGAGACACTCCGGTAGAATTATCACT
ATCCCTAGCGTTTTTTCCTGTGGTGCAATA|ATAAGAATTGAGACACTCCGGTAGAATTAT
CAGGGTATTCCGTGTGAGGAGATGTGACCA|TGTGACCATAAGAATTGGTGAGGAGATGTG
TAGCGTTTTTTCCTGTGGTGCAATAGCGTC|AATTGAGACACTCCGGTAGAATTATCACTT
ACGAATGGCCGTCGTGTCGTGTTGACCGTA|GGGGACCCCGGGTCCATCAAACTAAGACTG
TCAGTACCACCAAGATTTGGGCCCGTGTGA|GACTTAGGAGAACGACATGGGTTGGAAATT
GAATTGGTCGAGCGATAGGGGCCATCGCAA|TGTGACCATAAGAATTGACCAACTGGCGCC
AGCGGTGATAAGAGAGGCCATCTCAAACTT|TAAGAATTGTGCGTTTTTGTCCAATGGTAC
GACTGCGCTATCCGGTTCCTTTTCGCACCA|GCCCGTGTGAGGAGATGTGACCATAAGAAT
GATGTGACCACCGTGTGAGGAGATGTGACC|AGAATTGCTTACCAATGACACCGTGATCCC
TAAGAATTGTGCGTTTTTGTCCAATGGTAC|TTGTTTGAGCTTCCAGGACCAGTAAGAAGG
AGGAGATGTGACCATAAGAATTCCGTGTGA|TCCGTGTGAGGAGATGTGACCATAAGAATT
CCTCGATTTCACCTTCCGTGTGAGGAGATG|TACACGACTGTTATGCTGCACTGCGCAACT
TGGTGCAATAGCGTCCTTTCAACGAATCAA|GTAGAATTATCACTTTTATGTAACCGTGTG
GTGACCACCGTGTGAGGAGATGTGACCATA|ATTGCTTACCAATGACACCGTGATCCCGTG
AAGAATTGGTAAGCTTCCGGATCCGATTAT|GTGTACTGCGCCTGTGCATCTGGGTTGTCG
CGACTGTTATGCTGCACTGCGCAACTTTGT|GAGAAAGGCCACTGATTTCTCTGTGTAGCC
GGAGATGTGACCATAAGAATTGACCAACTG|GCGGACCGCAATTCGATTCTGAGGGATGTC
GAAAGGAGTAGTAGGGGTGTGGGGTAAAGA|GCTATCCGGTTCCTTTTCGCACCACCGTGT
AAAGCGAGAGCGGTGATAAGAGAGGCCATC|TGTGACCATAAGAATTGTGCGTTTTTGTCC
GCCGGCGTGTACCATACGGCAACGCTATAT|AATTGCAGCTAACTTACCGTCCGTGTGAGG
GAGGCCATCTCAAACTTGCAGACATCTTAC|TTTTTGTCCAATGGTACGAATGGCCGTCGT
ATAAGAATTGACCAACTGGCGCCGCGCGTG|TCGATTCTGAGGGATGTCGTCTCTCAGCCG
CGCGAAAGCGAGAGCGGTGATAAGAGAGGC|GAGATGTGACCATAAGAATTGTGCGTTTTT
CATCTCAAACTTGCAGACATCTTACCCGTT|GTCCAATGGTACGAATGGCCGTCGTGTCGT
GATGAGCAGGCGTACCGTGTGAGGAGATGT|GAGGAGATGTGACCATAAGAATTGGCCGGC
TGCGCTATCCGGTTCCTTTTCGCACCACCG|CGTGTGAGGAGATGTGACCATAAGAATTCC
CATAAGAATTGATCCGTGTGAGGAGATGTG|CCAATCACTAAATGGTTATCAGCGGACCGC
AACTTGCAGACATCTTACCCGTTCAATCAG|GGTACGAATGGCCGTCGTGTCGTGTTGACC
ACCAGTAAGAAGGGGACCCCGGGTCCATCA|ATCACATTGTACCAAATCAGTACCACCAAG
AACTGGCGCCGCGCGTGTTCGTTGGCTTAG|ATGTCGTCTCTCAGCCGTATGATAAGAAGC
ATGAAAGGAGTAGTAGGGGTGTGGGGTAAA|GCGCTATCCGGTTCCTTTTCGCACCACCGT
AAGAATTGGTCGAGCGATAGGGGCCATCGC|GATGTGACCATAAGAATTGACCAACTGGCG
AGTGCCGTCCTCGATTTCACCTTCCGTGTG|GTGAAACGTACACGACTGTTATGCTGCACT
GTGTGAGGAGATGTGACCATAAGAATTCCG|GAAATTCCGTGTGAGGAGATGTGACCATAA
ATCTTTAAATGCCCAGGGAGCCGGCGTGTA|GAGGAGATGTGACCATAAGAATTGCAGCTA
CATACCGTGTGAGGAGATGTGACCACCGTG|GGAGATGTGACCATAAGAATTGCTTACCAA
GAGAGGCCATCTCAAACTTGCAGACATCTT|CGTTTTTGTCCAATGGTACGAATGGCCGTC
CTGTGTAGCCTGAGGCCGTGTGAGGAGATG|GCAGGCGTACCGTGTGAGGAGATGTGACCA
ATAAGAATTGGTGAGGAGATGTGACCATAA|TGTGACCATAAGAATTGTAAGAATTGATGT
GGAGATGTGACCATAAGAATTCCGTGTGAG|CCGTGTGAGGAGATGTGACCATAAGAATTG
ATCCGATTATAATAGGCTGGGTATGGTATG|TGGGTTGTCGATCAGTGCCGTCCTCGATTT
ACCAAGATTTGGGCCCGTGTGAGGAGATGT|AGAACGACATGGGTTGGAAATTCCGTGTGA
TGAATCCCTAGCGTTTTTTCCTGTGGTGCA|ACCATAAGAATTGAGACACTCCGGTAGAAT
GGAGATGTGACCATAAGAATTGGTCGAGCG|GATCCGTGTGAGGAGATGTGACCATAAGAA
GTTAGATACGTTTTGAGAAAGGCCACTGAT|AAAGGAGTAGTAGGGGTGTGGGGTAAAGAG
CGATTTCACCTTCCGTGTGAGGAGATGTGA|ACGACTGTTATGCTGCACTGCGCAACTTTG
CCGTGTGAGGAGATGTGACCATAAGAATTG|ACCAATGACACCGTGATCCCGTGTGAGGAG
CCACCGTGTGAGGAGATGTGACCATAAGAA|AATTCCGTGTGAGGAGATGTGACCATAAGA
AACCGTGTGAGGAGATGTGACCATAAGAAT|GCTGGGTATGGTATGCCCACGGTGGCGGCC
CGGCAACGCTATATGGGCAGGGTATTCCGT|CCGTCCGTGTGAGGAGATGTGACCATAAGA
AATTGAGACACTCCGGTAGAATTATCACTT|TAAGAATTGGTAAGCTTCCGGATCCGATTA
ATTATCACTTTTATGTAACCGTGTGAGGAG|GATCCGATTATAATAGGCTGGGTATGGTAT
ACCGTCCGTGTGAGGAGATGTGACCATAAG|GAGATGTGACCACCGTGTGAGGAGATGTGA
CAGCCTTTGACGACCGCGAAAGCGAGAGCG|TGAGGCCGTGTGAGGAGATGTGACCATAAG
GATGTGACCATAAGAATTGGTGAGGAGATG|GTGAGGAGATGTGACCATAAGAATTGTAAG
CACGGTGGCGGCCATACCGTGTGAGGAGAT|CCTTCCGTGTGAGGAGATGTGACCATAAGA
ATAGGCTGGGTATGGTATGCCCACGGTGGC|TCAGTGCCGTCCTCGATTTCACCTTCCGTG
GTGACCATAAGAATTGGTCGAGCGATAGGG|TGTGAGGAGATGTGACCATAAGAATTGACC
GAGATGTGACCACCGTGTGAGGAGATGTGA|TAAGAATTGCTTACCAATGACACCGTGATC
CTTACCGTCCGTGTGAGGAGATGTGACCAT|GAGGAGATGTGACCACCGTGTGAGGAGATG
TACGAATGGCCGTCGTGTCGTGTTGACCGT|AGGGGACCCCGGGTCCATCAAACTAAGACT
CTTTTCGCACCACCGTGTGAGGAGATGTGA|GACCATAAGAATTCCGTGTGAGGAGATGTG
GGTATTCCGTGTGAGGAGATGTGACCATAA|GACCATAAGAATTGGTGAGGAGATGTGACC
TTTGAGAAAGGCCACTGATTTCTCTGTGTA|AGGGGTGTGGGGTAAAGAGATGAGCAGGCG
CCTTCCGTGTGAGGAGATGTGACCATAAGA|TATGCTGCACTGCGCAACTTTGTCAGCCTT
TACCAATGACACCGTGATCCCGTGTGAGGA|CCGCGAAAGCGAGAGCGGTGATAAGAGAGG
GACCAGTAAGAAGGGGACCCCGGGTCCATC|TATCACATTGTACCAAATCAGTACCACCAA
AGGAGATGTGACCATAAGAATTGAGACACT|GGTGAGGAGATGTGACCATAAGAATTGGTA
TGTGACCATAAGAATTGAGACATAGACATT|ATCTCAAACTTGCAGACATCTTACCCGTTC
TAAGAATTGCTTACCAATGACACCGTGATC|GCCTTTGACGACCGCGAAAGCGAGAGCGGT
TAAGCTTCCGGATCCGATTATAATAGGCTG|GCCTGTGCATCTGGGTTGTCGATCAGTGCC
TTGTGCGTTTTTGTCCAATGGTACGAATGG|GAGCTTCCAGGACCAGTAAGAAGGGGACCC
GCTAACTTACCGTCCGTGTGAGGAGATGTG|CGTGTGAGGAGATGTGACCACCGTGTGAGG
TTTGACGACCGCGAAAGCGAGAGCGGTGAT|CCGTGTGAGGAGATGTGACCATAAGAATTG
CGCTATCCGGTTCCTTTTCGCACCACCGTG|TGTGAGGAGATGTGACCATAAGAATTCCGT
GCAACGGTATTCGCGTTCAGAGAGGACTAG|CGCCGCGCGTGTTCGTTGGCTTAGATCTGT
CGTGTGAGGAGATGTGACCATAAGAATTGG|CCGTGTGAGGAGATGTGACCATAAGAATTG
TGTTGACCGTATGAAAGGAGTAGTAGGGGT|AACTAAGACTGCGCTATCCGGTTCCTTTTC
AACTAAGACTGCGCTATCCGGTTCCTTTTC|ATTTGGGCCCGTGTGAGGAGATGTGACCAT
AGATGTGACCATAAGAATTGTGCGTTTTTG|GACCATAAGAATTGTTTGAGCTTCCAGGAC
ATGTGACCATAAGAATTGGCCGGCGTTCGT|GATGTGACCATAAGAATTGGTCGAGCGATA
CAACGGTATTCGCGTTCAGAGAGGACTAGA|GCCGCGCGTGTTCGTTGGCTTAGATCTGTT
TGTGAGGAGATGTGACCATAAGAATTGTAA|AATGACACCGTGATCCCGTGTGAGGAGATG
AGGGTATTCCGTGTGAGGAGATGTGACCAT|GTGACCATAAGAATTGGTGAGGAGATGTGA
GTGACCATAAGAATTGTTTGAGCTTCCAGG|GCGTTCGTTGTTGAGTTGCAAACTTCAAGT
GGTCGAGCGATAGGGGCCATCGCAACGGTA|CCATAAGAATTGACCAACTGGCGCCGCGCG
GAGATGTGACCATAAGAATTGAGACACTCC|TGAGGAGATGTGACCATAAGAATTGGTAAG
TGAGGAGATGTGACCATAAGAATTGCAGCT|ATGGTATGCCCACGGTGGCGGCCATACCGT
AGATACGTTTTGAGAAAGGCCACTGATTTC|GGAGTAGTAGGGGTGTGGGGTAAAGAGATG
GAGATGTGACCATAAGAATTGTAAGAATTG|ACCGTGATCCCGTGTGAGGAGATGTGACCA
CATAAGAATTGACCAACTGGCGCCGCGCGT|TTCGATTCTGAGGGATGTCGTCTCTCAGCC
AATCAATCTTTAAATGCCCAGGGAGCCGGC|CGTGTGAGGAGATGTGACCATAAGAATTGC
AATTGACCAACTGGCGCCGCGCGTGTTCGT|TCTGAGGGATGTCGTCTCTCAGCCGTATGA
TGCAATAGCGTCCTTTCAACGAATCAATCT|GAATTATCACTTTTATGTAACCGTGTGAGG
TGTGAGGAGATGTGACCACCGTGTGAGGAG|TGACCATAAGAATTGCTTACCAATGACACC
GGTTCCTTTTCGCACCACCGTGTGAGGAGA|GATGTGACCATAAGAATTCCGTGTGAGGAG
AAGAATTGATGTGTACTGCGCCTGTGCATC|TGTGACCATAAGAATTGAGACATAGACATT
ATAAGAATTGAGACATAGACATTGCCAACA|ACTTGCAGACATCTTACCCGTTCAATCAGT
TCAGTAGCTGTTAGATACGTTTTGAGAAAG|GACCGTATGAAAGGAGTAGTAGGGGTGTGG
AATTCCGTGTGAGGAGATGTGACCATAAGA|CCTATAAAAATGAGGGGATTTGGCCAATCA
AGATGTGACCATAAGAATTGCAGCTAACTT|ATGCCCACGGTGGCGGCCATACCGTGTGAG
GCAGCTAACTTACCGTCCGTGTGAGGAGAT|TACCGTGTGAGGAGATGTGACCACCGTGTG
GCGTTCAGAGAGGACTAGACTTAGGAGAAC|TCGTTGGCTTAGATCTGTTTTTTCCTAGCT
AAGAATTGAGACATAGACATTGCCAACACA|TTGCAGACATCTTACCCGTTCAATCAGTAG
TACCGTCCGTGTGAGGAGATGTGACCATAA|GGAGATGTGACCACCGTGTGAGGAGATGTG
GGCAGGGTATTCCGTGTGAGGAGATGTGAC|GATGTGACCATAAGAATTGGTGAGGAGATG
GAGGAGATGTGACCATAAGAATTGAGACAT|AGAGGCCATCTCAAACTTGCAGACATCTTA
ACGGCAACGCTATATGGGCAGGGTATTCCG|ACCGTCCGTGTGAGGAGATGTGACCATAAG
AGAAAGGCCACTGATTTCTCTGTGTAGCCT|GTGTGGGGTAAAGAGATGAGCAGGCGTACC
GAGTAGTAGGGGTGTGGGGTAAAGAGATGA|CCGGTTCCTTTTCGCACCACCGTGTGAGGA
GCAGGGTATTCCGTGTGAGGAGATGTGACC|ATGTGACCATAAGAATTGGTGAGGAGATGT
AGGAGATGTGACCATAAGAATTGCAGCTAA|GGTATGCCCACGGTGGCGGCCATACCGTGT
CATACGGCAACGCTATATGGGCAGGGTATT|CTTACCGTCCGTGTGAGGAGATGTGACCAT
AGGAGATGTGACCATAAGAATTGATCCGTG|GAGGGGATTTGGCCAATCACTAAATGGTTA
TGCGCCTGTGCATCTGGGTTGTCGATCAGT|GAGACATAGACATTGCCAACACACAGAGTG
GGTTGGAAATTCCGTGTGAGGAGATGTGAC|GGTGGCTCCTATAAAAATGAGGGGATTTGG
GGAGATGTGACCATAAGAATTGTGCGTTTT|GTGACCATAAGAATTGTTTGAGCTTCCAGG
TAGATACGTTTTGAGAAAGGCCACTGATTT|AGGAGTAGTAGGGGTGTGGGGTAAAGAGAT
GATACGTTTTGAGAAAGGCCACTGATTTCT|GAGTAGTAGGGGTGTGGGGTAAAGAGATGA
GTTGTTGAGTTGCAAACTTCAAGTATCACA|TAGGGGCCATCGCAACGGTATTCGCGTTCA
TCAACGAATCAATCTTTAAATGCCCAGGGA|TGTAACCGTGTGAGGAGATGTGACCATAAG
TTTTTCCTGTGGTGCAATAGCGTCCTTTCA|GACACTCCGGTAGAATTATCACTTTTATGT
CTTCCGGATCCGATTATAATAGGCTGGGTA|GTGCATCTGGGTTGTCGATCAGTGCCGTCC
GAGAGGACTAGACTTAGGAGAACGACATGG|CTTAGATCTGTTTTTTCCTAGCTGTAACGG
ACACTCCGGTAGAATTATCACTTTTATGTA|TGGTAAGCTTCCGGATCCGATTATAATAGG
AGCTTCCGGATCCGATTATAATAGGCTGGG|CTGTGCATCTGGGTTGTCGATCAGTGCCGT
CCATACGGCAACGCTATATGGGCAGGGTAT|ACTTACCGTCCGTGTGAGGAGATGTGACCA
GACATGGGTTGGAAATTCCGTGTGAGGAGA|GTAACGGGTGGCTCCTATAAAAATGAGGGG
AAGGCCACTGATTTCTCTGTGTAGCCTGAG|TGGGGTAAAGAGATGAGCAGGCGTACCGTG
GATTTCACCTTCCGTGTGAGGAGATGTGAC|CGACTGTTATGCTGCACTGCGCAACTTTGT
TGATAAGAGAGGCCATCTCAAACTTGCAGA|ATTGTGCGTTTTTGTCCAATGGTACGAATG
CCATAAGAATTGACCAACTGGCGCCGCGCG|ATTCGATTCTGAGGGATGTCGTCTCTCAGC
GGTGTGGGGTAAAGAGATGAGCAGGCGTAC|TTCGCACCACCGTGTGAGGAGATGTGACCA
TGATCCGTGTGAGGAGATGTGACCATAAGA|AAATGGTTATCAGCGGACCGCAATTCGATT
TAGTAGGGGTGTGGGGTAAAGAGATGAGCA|GTTCCTTTTCGCACCACCGTGTGAGGAGAT
TGTGACCATAAGAATTGCTTACCAATGACA|CTTTGTCAGCCTTTGACGACCGCGAAAGCG
GAGTTGCAAACTTCAAGTATCACATTGTAC|CCATCGCAACGGTATTCGCGTTCAGAGAGG
ATAAGAATTGAGACACTCCGGTAGAATTAT|GACCATAAGAATTGGTAAGCTTCCGGATCC
GTCGTGTCGTGTTGACCGTATGAAAGGAGT|GGTCCATCAAACTAAGACTGCGCTATCCGG
GAGGAGATGTGACCATAAGAATTGGTCGAG|TTGATCCGTGTGAGGAGATGTGACCATAAG
TTGGTCGAGCGATAGGGGCCATCGCAACGG|GACCATAAGAATTGACCAACTGGCGCCGCG
CGGTGATAAGAGAGGCCATCTCAAACTTGC|AGAATTGTGCGTTTTTGTCCAATGGTACGA
ATGTGTACTGCGCCTGTGCATCTGGGTTGT|TAAGAATTGAGACATAGACATTGCCAACAC
TTCAATCAGTAGCTGTTAGATACGTTTTGA|GTGTTGACCGTATGAAAGGAGTAGTAGGGG
AGGAGATGTGACCATAAGAATTGGTAAGCT|ATTGTAAGAATTGATGTGTACTGCGCCTGT
GACCATAAGAATTGCTTACCAATGACACCG|TGTCAGCCTTTGACGACCGCGAAAGCGAGA
CCATAAGAATTGTTTGAGCTTCCAGGACCA|TCGTTGTTGAGTTGCAAACTTCAAGTATCA
GATGTGACCATAAGAATTGTTTGAGCTTCC|CCGGCGTTCGTTGTTGAGTTGCAAACTTCA
ATGTGACCATAAGAATTGCTTACCAATGAC|ACTTTGTCAGCCTTTGACGACCGCGAAAGC
TCTTACCCGTTCAATCAGTAGCTGTTAGAT|CGTCGTGTCGTGTTGACCGTATGAAAGGAG
GTGTGAGGAGATGTGACCATAAGAATTGAT|AAAATGAGGGGATTTGGCCAATCACTAAAT
AATTGGTAAGCTTCCGGATCCGATTATAAT|TACTGCGCCTGTGCATCTGGGTTGTCGATC
ATCCCGTGTGAGGAGATGTGACCATAAGAA|GGTGATAAGAGAGGCCATCTCAAACTTGCA
ATTGTGCGTTTTTGTCCAATGGTACGAATG|TGAGCTTCCAGGACCAGTAAGAAGGGGACC
TGAGGAGATGTGACCATAAGAATTGGTAAG|GAATTGTAAGAATTGATGTGTACTGCGCCT
GAGGAGATGTGACCATAAGAATTGACCAAC|CAGCGGACCGCAATTCGATTCTGAGGGATG
TGGTATGCCCACGGTGGCGGCCATACCGTG|TCGATTTCACCTTCCGTGTGAGGAGATGTG
CTTTCAACGAATCAATCTTTAAATGCCCAG|TTATGTAACCGTGTGAGGAGATGTGACCAT
CCCAGGGAGCCGGCGTGTACCATACGGCAA|ACCATAAGAATTGCAGCTAACTTACCGTCC
CCCACGGTGGCGGCCATACCGTGTGAGGAG|CACCTTCCGTGTGAGGAGATGTGACCATAA
TGAAACGTACACGACTGTTATGCTGCACTG|AGATACGTTTTGAGAAAGGCCACTGATTTC
ACCATAAGAATTGCAGCTAACTTACCGTCC|CGGTGGCGGCCATACCGTGTGAGGAGATGT
CCTGTGGTGCAATAGCGTCCTTTCAACGAA|TCCGGTAGAATTATCACTTTTATGTAACCG
TGAGGAGATGTGACCATAAGAATTGAGACA|TTGGTGAGGAGATGTGACCATAAGAATTGG
TGTGACCATAAGAATTGTGCGTTTTTGTCC|CATAAGAATTGTTTGAGCTTCCAGGACCAG
CCATAAGAATTGGCCGGCGTTCGTTGTTGA|ACCATAAGAATTGGTCGAGCGATAGGGGCC
TAGACATTGCCAACACACAGAGTGAAACGT|ACCCGTTCAATCAGTAGCTGTTAGATACGT
CACACAGAGTGAAACGTACACGACTGTTAT|GTAGCTGTTAGATACGTTTTGAGAAAGGCC
AATGGCCGTCGTGTCGTGTTGACCGTATGA|GACCCCGGGTCCATCAAACTAAGACTGCGC
TTATGCTGCACTGCGCAACTTTGTCAGCCT|GGCCACTGATTTCTCTGTGTAGCCTGAGGC
CCGTATGAAAGGAGTAGTAGGGGTGTGGGG|GACTGCGCTATCCGGTTCCTTTTCGCACCA
GAGATGTGACCATAAGAATTGGTGAGGAGA|GTGTGAGGAGATGTGACCATAAGAATTGTA
GTGATCCCGTGTGAGGAGATGTGACCATAA|AGCGGTGATAAGAGAGGCCATCTCAAACTT
ACACGACTGTTATGCTGCACTGCGCAACTT|TTTGAGAAAGGCCACTGATTTCTCTGTGTA
GCGAGAGCGGTGATAAGAGAGGCCATCTCA|GACCATAAGAATTGTGCGTTTTTGTCCAAT
TGTGACCATAAGAATTGGTCGAGCGATAGG|GTGTGAGGAGATGTGACCATAAGAATTGAC
AATGGTACGAATGGCCGTCGTGTCGTGTTG|TAAGAAGGGGACCCCGGGTCCATCAAACTA
AAGAATTGATCCGTGTGAGGAGATGTGACC|ATCACTAAATGGTTATCAGCGGACCGCAAT
CACTTTTATGTAACCGTGTGAGGAGATGTG|GATTATAATAGGCTGGGTATGGTATGCCCA
CTAGACTTAGGAGAACGACATGGGTTGGAA|CTGTTTTTTCCTAGCTGTAACGGGTGGCTC
CACTGATTTCTCTGTGTAGCCTGAGGCCGT|TAAAGAGATGAGCAGGCGTACCGTGTGAGG
CCCGTTCAATCAGTAGCTGTTAGATACGTT|TGTCGTGTTGACCGTATGAAAGGAGTAGTA
CCTTTGACGACCGCGAAAGCGAGAGCGGTG|GGCCGTGTGAGGAGATGTGACCATAAGAAT
TTGACCAACTGGCGCCGCGCGTGTTCGTTG|TGAGGGATGTCGTCTCTCAGCCGTATGATA
GTGAGGAGATGTGACCATAAGAATTGTGCG|AGATGTGACCATAAGAATTGTTTGAGCTTC
CCAACTGGCGCCGCGCGTGTTCGTTGGCTT|GGATGTCGTCTCTCAGCCGTATGATAAGAA
CAGTGCCGTCCTCGATTTCACCTTCCGTGT|AGTGAAACGTACACGACTGTTATGCTGCAC
GAGGAGATGTGACCATAAGAATTGATCCGT|TGAGGGGATTTGGCCAATCACTAAATGGTT
CAAATCAGTACCACCAAGATTTGGGCCCGT|ACTAGACTTAGGAGAACGACATGGGTTGGA
GTGAGGAGATGTGACCATAAGAATTCCGTG|AATTCCGTGTGAGGAGATGTGACCATAAGA
TCTGTGTAGCCTGAGGCCGTGTGAGGAGAT|AGCAGGCGTACCGTGTGAGGAGATGTGACC
GCCTGTGCATCTGGGTTGTCGATCAGTGCC|ACATAGACATTGCCAACACACAGAGTGAAA
GTATCACATTGTACCAAATCAGTACCACCA|CGCGTTCAGAGAGGACTAGACTTAGGAGAA
TGAGGAGATGTGACCATAAGAATTGGCCGG|GTGAGGAGATGTGACCATAAGAATTGGTCG
CCAGTAAGAAGGGGACCCCGGGTCCATCAA|TCACATTGTACCAAATCAGTACCACCAAGA
GTCGAGCGATAGGGGCCATCGCAACGGTAT|CATAAGAATTGACCAACTGGCGCCGCGCGT
CATAAGAATTCCGTGTGAGGAGATGTGACC|GATGTGACCATAAGAATTGATCCGTGTGAG
GGGCAGGGTATTCCGTGTGAGGAGATGTGA|AGATGTGACCATAAGAATTGGTGAGGAGAT
GGAGATGTGACCATAAGAATTGAGACATAG|AGGCCATCTCAAACTTGCAGACATCTTACC
CAACGAATCAATCTTTAAATGCCCAGGGAG|GTAACCGTGTGAGGAGATGTGACCATAAGA
AGAGTGAAACGTACACGACTGTTATGCTGC|TGTTAGATACGTTTTGAGAAAGGCCACTGA
GCAGGCGTACCGTGTGAGGAGATGTGACCA|GATGTGACCATAAGAATTGGCCGGCGTTCG
AGAATTGCAGCTAACTTACCGTCCGTGTGA|CGGCCATACCGTGTGAGGAGATGTGACCAC
CCAGGGAGCCGGCGTGTACCATACGGCAAC|CCATAAGAATTGCAGCTAACTTACCGTCCG
TGAGGAGATGTGACCATAAGAATTGACCAA|TCAGCGGACCGCAATTCGATTCTGAGGGAT
GGCCATCGCAACGGTATTCGCGTTCAGAGA|CAACTGGCGCCGCGCGTGTTCGTTGGCTTA
GAATTGGCCGGCGTTCGTTGTTGAGTTGCA|AGAATTGGTCGAGCGATAGGGGCCATCGCA
CTGCGCCTGTGCATCTGGGTTGTCGATCAG|TGAGACATAGACATTGCCAACACACAGAGT
ACACAGAGTGAAACGTACACGACTGTTATG|TAGCTGTTAGATACGTTTTGAGAAAGGCCA
GGAGATGTGACCATAAGAATTGGCCGGCGT|AGGAGATGTGACCATAAGAATTGGTCGAGC
AGAATTGATGTGTACTGCGCCTGTGCATCT|GTGACCATAAGAATTGAGACATAGACATTG
GGTATTCGCGTTCAGAGAGGACTAGACTTA|CGCGTGTTCGTTGGCTTAGATCTGTTTTTT
TGTGACCATAAGAATTGGTAAGCTTCCGGA|AGAATTGATGTGTACTGCGCCTGTGCATCT
CCGTGTGAGGAGATGTGACCATAAGAATTG|GGTTATCAGCGGACCGCAATTCGATTCTGA
TAAGAATTGAGACACTCCGGTAGAATTATC|ACCATAAGAATTGGTAAGCTTCCGGATCCG
TTCCAGGACCAGTAAGAAGGGGACCCCGGG|TTCAAGTATCACATTGTACCAAATCAGTAC
GAGGAGATGTGACCATAAGAATTGCTTACC|TGCGCAACTTTGTCAGCCTTTGACGACCGC
GCGTGTACCATACGGCAACGCTATATGGGC|GCAGCTAACTTACCGTCCGTGTGAGGAGAT
GTACACGACTGTTATGCTGCACTGCGCAAC|GTTTTGAGAAAGGCCACTGATTTCTCTGTG
AGGCCGTGTGAGGAGATGTGACCATAAGAA|TGTGAGGAGATGTGACCATAAGAATTGTTT
TCCGTGTGAGGAGATGTGACCATAAGAATT|TAAGAATTGGTGAGGAGATGTGACCATAAG
TGAGGCCGTGTGAGGAGATGTGACCATAAG|CGTGTGAGGAGATGTGACCATAAGAATTGT
GCCATACCGTGTGAGGAGATGTGACCACCG|GAGGAGATGTGACCATAAGAATTGCTTACC
TTGCAAACTTCAAGTATCACATTGTACCAA|TCGCAACGGTATTCGCGTTCAGAGAGGACT
GGGTCCATCAAACTAAGACTGCGCTATCCG|TACCACCAAGATTTGGGCCCGTGTGAGGAG
TGACCATAAGAATTGTAAGAATTGATGTGT|ATCCCGTGTGAGGAGATGTGACCATAAGAA
TTCAACGAATCAATCTTTAAATGCCCAGGG|ATGTAACCGTGTGAGGAGATGTGACCATAA
CTGGGTATGGTATGCCCACGGTGGCGGCCA|GCCGTCCTCGATTTCACCTTCCGTGTGAGG
CCCGTGTGAGGAGATGTGACCATAAGAATT|TGATAAGAGAGGCCATCTCAAACTTGCAGA
GGTGATAAGAGAGGCCATCTCAAACTTGCA|GAATTGTGCGTTTTTGTCCAATGGTACGAA
GAGAAAGGCCACTGATTTCTCTGTGTAGCC|GGTGTGGGGTAAAGAGATGAGCAGGCGTAC
GTGTGAGGAGATGTGACCATAAGAATTGCA|GGTATGGTATGCCCACGGTGGCGGCCATAC
AAGGGGACCCCGGGTCCATCAAACTAAGAC|TACCAAATCAGTACCACCAAGATTTGGGCC
GACCGTATGAAAGGAGTAGTAGGGGTGTGG|AAGACTGCGCTATCCGGTTCCTTTTCGCAC
GCGTTTTTGTCCAATGGTACGAATGGCCGT|TTCCAGGACCAGTAAGAAGGGGACCCCGGG
TAGCTGTTAGATACGTTTTGAGAAAGGCCA|GTATGAAAGGAGTAGTAGGGGTGTGGGGTA
TTGCCAACACACAGAGTGAAACGTACACGA|TCAATCAGTAGCTGTTAGATACGTTTTGAG
GGAGATGTGACCACCGTGTGAGGAGATGTG|ATAAGAATTGCTTACCAATGACACCGTGAT
CAGCTAACTTACCGTCCGTGTGAGGAGATG|ACCGTGTGAGGAGATGTGACCACCGTGTGA
TGTCGTGTTGACCGTATGAAAGGAGTAGTA|CATCAAACTAAGACTGCGCTATCCGGTTCC
ATCCGGTTCCTTTTCGCACCACCGTGTGAG|AGGAGATGTGACCATAAGAATTCCGTGTGA
GCGATAGGGGCCATCGCAACGGTATTCGCG|GAATTGACCAACTGGCGCCGCGCGTGTTCG
ACATTGCCAACACACAGAGTGAAACGTACA|CGTTCAATCAGTAGCTGTTAGATACGTTTT
AGGCCATCTCAAACTTGCAGACATCTTACC|TTTTGTCCAATGGTACGAATGGCCGTCGTG
GTGAGGAGATGTGACCATAAGAATTGAGAC|ATTGGTGAGGAGATGTGACCATAAGAATTG
GCTTCCGGATCCGATTATAATAGGCTGGGT|TGTGCATCTGGGTTGTCGATCAGTGCCGTC
ATTGTTTGAGCTTCCAGGACCAGTAAGAAG|GAGTTGCAAACTTCAAGTATCACATTGTAC
CCGTGTGAGGAGATGTGACCATAAGAATTG|GTGACCACCGTGTGAGGAGATGTGACCATA
ACCCGTTCAATCAGTAGCTGTTAGATACGT|GTGTCGTGTTGACCGTATGAAAGGAGTAGT
TAAGAATTGGTAAGCTTCCGGATCCGATTA|TGTGTACTGCGCCTGTGCATCTGGGTTGTC
TGTGAGGAGATGTGACCATAAGAATTCCGT|AAATTCCGTGTGAGGAGATGTGACCATAAG
CCGGCGTTCGTTGTTGAGTTGCAAACTTCA|GTCGAGCGATAGGGGCCATCGCAACGGTAT
GACCCCGGGTCCATCAAACTAAGACTGCGC|AATCAGTACCACCAAGATTTGGGCCCGTGT
TGAGACATAGACATTGCCAACACACAGAGT|ACATCTTACCCGTTCAATCAGTAGCTGTTA
GATTATAATAGGCTGGGTATGGTATGCCCA|TTGTCGATCAGTGCCGTCCTCGATTTCACC
TCGTTGTTGAGTTGCAAACTTCAAGTATCA|GATAGGGGCCATCGCAACGGTATTCGCGTT
CTGTTAGATACGTTTTGAGAAAGGCCACTG|TGAAAGGAGTAGTAGGGGTGTGGGGTAAAG
TTGTAAGAATTGATGTGTACTGCGCCTGTG|GAGATGTGACCATAAGAATTGAGACATAGA
CCATAAGAATTGGTCGAGCGATAGGGGCCA|AGGAGATGTGACCATAAGAATTGACCAACT
AGAATTCCGTGTGAGGAGATGTGACCATAA|TGACCATAAGAATTGATCCGTGTGAGGAGA
CCAAATCAGTACCACCAAGATTTGGGCCCG|GACTAGACTTAGGAGAACGACATGGGTTGG
CGTTCGTTGTTGAGTTGCAAACTTCAAGTA|AGCGATAGGGGCCATCGCAACGGTATTCGC
CGGCGTGTACCATACGGCAACGCTATATGG|TTGCAGCTAACTTACCGTCCGTGTGAGGAG
GGCCGTGTGAGGAGATGTGACCATAAGAAT|GTGAGGAGATGTGACCATAAGAATTGTTTG
GAGATGTGACCATAAGAATTGGTAAGCTTC|TGTAAGAATTGATGTGTACTGCGCCTGTGC
TGGGTTGGAAATTCCGTGTGAGGAGATGTG|CGGGTGGCTCCTATAAAAATGAGGGGATTT
AGGAGATGTGACCATAAGAATTGGTGAGGA|CCGTGTGAGGAGATGTGACCATAAGAATTG
CGTGTGAGGAGATGTGACCATAAGAATTGA|ATAAGAGAGGCCATCTCAAACTTGCAGACA
TGTTATGCTGCACTGCGCAACTTTGTCAGC|AAGGCCACTGATTTCTCTGTGTAGCCTGAG
GTGTGAGGAGATGTGACCATAAGAATTGGT|GACCACCGTGTGAGGAGATGTGACCATAAG
ATGTAACCGTGTGAGGAGATGTGACCATAA|ATAGGCTGGGTATGGTATGCCCACGGTGGC
GCAAACTTCAAGTATCACATTGTACCAAAT|GCAACGGTATTCGCGTTCAGAGAGGACTAG
CACCGTGTGAGGAGATGTGACCATAAGAAT|TTACCAATGACACCGTGATCCCGTGTGAGG
TCAGTGCCGTCCTCGATTTCACCTTCCGTG|GAGTGAAACGTACACGACTGTTATGCTGCA
GGGACCCCGGGTCCATCAAACTAAGACTGC|CAAATCAGTACCACCAAGATTTGGGCCCGT
GCTGGGTATGGTATGCCCACGGTGGCGGCC|TGCCGTCCTCGATTTCACCTTCCGTGTGAG
CCGTGTGAGGAGATGTGACCATAAGAATTG|GAGGAGATGTGACCATAAGAATTGTTTGAG
AAGAATTGTAAGAATTGATGTGTACTGCGC|GTGAGGAGATGTGACCATAAGAATTGAGAC
TCCTCGATTTCACCTTCCGTGTGAGGAGAT|GTACACGACTGTTATGCTGCACTGCGCAAC
ACCACCGTGTGAGGAGATGTGACCATAAGA|GAATTCCGTGTGAGGAGATGTGACCATAAG
TCACCTTCCGTGTGAGGAGATGTGACCATA|TGTTATGCTGCACTGCGCAACTTTGTCAGC
CGGTTCCTTTTCGCACCACCGTGTGAGGAG|AGATGTGACCATAAGAATTCCGTGTGAGGA
ACCAATGACACCGTGATCCCGTGTGAGGAG|CGCGAAAGCGAGAGCGGTGATAAGAGAGGC
AAGAATTGGCCGGCGTTCGTTGTTGAGTTG|TAAGAATTGGTCGAGCGATAGGGGCCATCG
TCAAACTAAGACTGCGCTATCCGGTTCCTT|AAGATTTGGGCCCGTGTGAGGAGATGTGAC
GTAAGCTTCCGGATCCGATTATAATAGGCT|CGCCTGTGCATCTGGGTTGTCGATCAGTGC
TACACGACTGTTATGCTGCACTGCGCAACT|TTTTGAGAAAGGCCACTGATTTCTCTGTGT
GTGTGAGGAGATGTGACCATAAGAATTGGT|AGAATTGATCCGTGTGAGGAGATGTGACCA
ACACACAGAGTGAAACGTACACGACTGTTA|AGTAGCTGTTAGATACGTTTTGAGAAAGGC
TTTTGTCCAATGGTACGAATGGCCGTCGTG|AGGACCAGTAAGAAGGGGACCCCGGGTCCA
GTGTGAGGAGATGTGACCATAAGAATTGAG|TAAGAGAGGCCATCTCAAACTTGCAGACAT
CTTTTATGTAACCGTGTGAGGAGATGTGAC|TTATAATAGGCTGGGTATGGTATGCCCACG
TATCCGGTTCCTTTTCGCACCACCGTGTGA|GAGGAGATGTGACCATAAGAATTCCGTGTG
TCGATCAGTGCCGTCCTCGATTTCACCTTC|CACAGAGTGAAACGTACACGACTGTTATGC
AGAGAGGCCATCTCAAACTTGCAGACATCT|GCGTTTTTGTCCAATGGTACGAATGGCCGT
TAAGAATTGACCAACTGGCGCCGCGCGTGT|CGATTCTGAGGGATGTCGTCTCTCAGCCGT
AGGAGATGTGACCATAAGAATTGCTTACCA|GCGCAACTTTGTCAGCCTTTGACGACCGCG
TGTACCATACGGCAACGCTATATGGGCAGG|GCTAACTTACCGTCCGTGTGAGGAGATGTG
GTGTGAGGAGATGTGACCATAAGAATTGAG|GAATTGGTGAGGAGATGTGACCATAAGAAT
ACATGGGTTGGAAATTCCGTGTGAGGAGAT|TAACGGGTGGCTCCTATAAAAATGAGGGGA
CGTGTGAGGAGATGTGACCATAAGAATTGC|TGCACTGCGCAACTTTGTCAGCCTTTGACG
TGGGGTAAAGAGATGAGCAGGCGTACCGTG|CACCACCGTGTGAGGAGATGTGACCATAAG
CGTGTGAGGAGATGTGACCATAAGAATTGA|GTTATCAGCGGACCGCAATTCGATTCTGAG
CGTGTGAGGAGATGTGACCATAAGAATTGC|GGGTATGGTATGCCCACGGTGGCGGCCATA
CAATCAGTAGCTGTTAGATACGTTTTGAGA|GTTGACCGTATGAAAGGAGTAGTAGGGGTG
AGAACGACATGGGTTGGAAATTCCGTGTGA|TAGCTGTAACGGGTGGCTCCTATAAAAATG
TAACTTACCGTCCGTGTGAGGAGATGTGAC|TGTGAGGAGATGTGACCACCGTGTGAGGAG
GGCCCGTGTGAGGAGATGTGACCATAAGAA|GGTTGGAAATTCCGTGTGAGGAGATGTGAC
ACATAGACATTGCCAACACACAGAGTGAAA|CTTACCCGTTCAATCAGTAGCTGTTAGATA
ATCAGTAGCTGTTAGATACGTTTTGAGAAA|TGACCGTATGAAAGGAGTAGTAGGGGTGTG
GCGTTTTTTCCTGTGGTGCAATAGCGTCCT|TTGAGACACTCCGGTAGAATTATCACTTTT
CAACACACAGAGTGAAACGTACACGACTGT|TCAGTAGCTGTTAGATACGTTTTGAGAAAG
GTGCAATAGCGTCCTTTCAACGAATCAATC|AGAATTATCACTTTTATGTAACCGTGTGAG
ATGTGACCATAAGAATTGTAAGAATTGATG|GTGATCCCGTGTGAGGAGATGTGACCATAA
GAAAGCGAGAGCGGTGATAAGAGAGGCCAT|ATGTGACCATAAGAATTGTGCGTTTTTGTC
CCAAGATTTGGGCCCGTGTGAGGAGATGTG|GAACGACATGGGTTGGAAATTCCGTGTGAG
CTCCGGTAGAATTATCACTTTTATGTAACC|TAAGCTTCCGGATCCGATTATAATAGGCTG
GATTTGGGCCCGTGTGAGGAGATGTGACCA|GACATGGGTTGGAAATTCCGTGTGAGGAGA
GAGATGTGACCATAAGAATTCCGTGTGAGG|CGTGTGAGGAGATGTGACCATAAGAATTGA
TGTGCGTTTTTGTCCAATGGTACGAATGGC|AGCTTCCAGGACCAGTAAGAAGGGGACCCC
AGAATTGAGACACTCCGGTAGAATTATCAC|CATAAGAATTGGTAAGCTTCCGGATCCGAT
CAAACTAAGACTGCGCTATCCGGTTCCTTT|AGATTTGGGCCCGTGTGAGGAGATGTGACC
GTGAGGAGATGTGACCATAAGAATTGTAAG|ATGACACCGTGATCCCGTGTGAGGAGATGT
AACTTTGTCAGCCTTTGACGACCGCGAAAG|GTGTAGCCTGAGGCCGTGTGAGGAGATGTG
GAGGAGATGTGACCATAAGAATTGCAGCTA|TGGTATGCCCACGGTGGCGGCCATACCGTG
CGTACACGACTGTTATGCTGCACTGCGCAA|CGTTTTGAGAAAGGCCACTGATTTCTCTGT
TTCTCTGTGTAGCCTGAGGCCGTGTGAGGA|ATGAGCAGGCGTACCGTGTGAGGAGATGTG
TTCGCGTTCAGAGAGGACTAGACTTAGGAG|TGTTCGTTGGCTTAGATCTGTTTTTTCCTA
GGTTGTCGATCAGTGCCGTCCTCGATTTCA|CAACACACAGAGTGAAACGTACACGACTGT
CGGTGGCGGCCATACCGTGTGAGGAGATGT|TTCCGTGTGAGGAGATGTGACCATAAGAAT
GACCATAAGAATTGTAAGAATTGATGTGTA|TCCCGTGTGAGGAGATGTGACCATAAGAAT
CCGTGATCCCGTGTGAGGAGATGTGACCAT|AGAGCGGTGATAAGAGAGGCCATCTCAAAC
TGGTAAGCTTCCGGATCCGATTATAATAGG|TGCGCCTGTGCATCTGGGTTGTCGATCAGT
GTGAGGAGATGTGACCATAAGAATTGAGAC|AGAGAGGCCATCTCAAACTTGCAGACATCT
AGATGTGACCATAAGAATTGAGACACTCCG|GAGGAGATGTGACCATAAGAATTGGTAAGC
GTTTTTTCCTGTGGTGCAATAGCGTCCTTT|GAGACACTCCGGTAGAATTATCACTTTTAT
GTAAAGAGATGAGCAGGCGTACCGTGTGAG|ACCGTGTGAGGAGATGTGACCATAAGAATT
TGTGACCATAAGAATTGATCCGTGTGAGGA|ATTTGGCCAATCACTAAATGGTTATCAGCG
AATCAGTAGCTGTTAGATACGTTTTGAGAA|TTGACCGTATGAAAGGAGTAGTAGGGGTGT
AGAATTGGTAAGCTTCCGGATCCGATTATA|TGTACTGCGCCTGTGCATCTGGGTTGTCGA
CTCTGTGTAGCCTGAGGCCGTGTGAGGAGA|GAGCAGGCGTACCGTGTGAGGAGATGTGAC
AACGACATGGGTTGGAAATTCCGTGTGAGG|GCTGTAACGGGTGGCTCCTATAAAAATGAG
GAATTGAGACATAGACATTGCCAACACACA|GCAGACATCTTACCCGTTCAATCAGTAGCT
ACCATAAGAATTGTGCGTTTTTGTCCAATG|AGAATTGTTTGAGCTTCCAGGACCAGTAAG
GTCAGCCTTTGACGACCGCGAAAGCGAGAG|CCTGAGGCCGTGTGAGGAGATGTGACCATA
TGACCATAAGAATTGACCAACTGGCGCCGC|GCAATTCGATTCTGAGGGATGTCGTCTCTC
GAGGAGATGTGACCATAAGAATTGGTAAGC|AATTGTAAGAATTGATGTGTACTGCGCCTG
ACGAATCAATCTTTAAATGCCCAGGGAGCC|AACCGTGTGAGGAGATGTGACCATAAGAAT
TATGTAACCGTGTGAGGAGATGTGACCATA|AATAGGCTGGGTATGGTATGCCCACGGTGG
AGAATTGGCCGGCGTTCGTTGTTGAGTTGC|AAGAATTGGTCGAGCGATAGGGGCCATCGC
ATGTGACCATAAGAATTGGTCGAGCGATAG|CGTGTGAGGAGATGTGACCATAAGAATTGA
GTGACCATAAGAATTGAGACACTCCGGTAG|AGATGTGACCATAAGAATTGGTAAGCTTCC
GATGTGACCATAAGAATTGGTCGAGCGATA|CCGTGTGAGGAGATGTGACCATAAGAATTG
GGAGTAGTAGGGGTGTGGGGTAAAGAGATG|TCCGGTTCCTTTTCGCACCACCGTGTGAGG
CCGTCCTCGATTTCACCTTCCGTGTGAGGA|AACGTACACGACTGTTATGCTGCACTGCGC
CGCGTTCAGAGAGGACTAGACTTAGGAGAA|TTCGTTGGCTTAGATCTGTTTTTTCCTAGC
AACACACAGAGTGAAACGTACACGACTGTT|CAGTAGCTGTTAGATACGTTTTGAGAAAGG
TGTGAGGAGATGTGACCATAAGAATTGGTC|GAATTGATCCGTGTGAGGAGATGTGACCAT
TAGGAGAACGACATGGGTTGGAAATTCCGT|TTCCTAGCTGTAACGGGTGGCTCCTATAAA
GAGATGTGACCATAAGAATTGAGACATAGA|GGCCATCTCAAACTTGCAGACATCTTACCC
TGACCGTATGAAAGGAGTAGTAGGGGTGTG|TAAGACTGCGCTATCCGGTTCCTTTTCGCA
GAGTGAAACGTACACGACTGTTATGCTGCA|GTTAGATACGTTTTGAGAAAGGCCACTGAT
ATGTGACCATAAGAATTGTTTGAGCTTCCA|CGGCGTTCGTTGTTGAGTTGCAAACTTCAA
AAGAATTGCAGCTAACTTACCGTCCGTGTG|GCGGCCATACCGTGTGAGGAGATGTGACCA
ACCATAAGAATTGGCCGGCGTTCGTTGTTG|GACCATAAGAATTGGTCGAGCGATAGGGGC
GGCGGCCATACCGTGTGAGGAGATGTGACC|GTGTGAGGAGATGTGACCATAAGAATTGCT
GATAGGGGCCATCGCAACGGTATTCGCGTT|ATTGACCAACTGGCGCCGCGCGTGTTCGTT
TTTCACCTTCCGTGTGAGGAGATGTGACCA|ACTGTTATGCTGCACTGCGCAACTTTGTCA
GGAGATGTGACCATAAGAATTGGTGAGGAG|CGTGTGAGGAGATGTGACCATAAGAATTGT
GGATCCGATTATAATAGGCTGGGTATGGTA|TCTGGGTTGTCGATCAGTGCCGTCCTCGAT
ACCGTGATCCCGTGTGAGGAGATGTGACCA|GAGAGCGGTGATAAGAGAGGCCATCTCAAA
GAATCCCTAGCGTTTTTTCCTGTGGTGCAA|CCATAAGAATTGAGACACTCCGGTAGAATT
AGTAGTAGGGGTGTGGGGTAAAGAGATGAG|CGGTTCCTTTTCGCACCACCGTGTGAGGAG
AGGAGATGTGACCATAAGAATTGAGACATA|GAGGCCATCTCAAACTTGCAGACATCTTAC
AACGGTATTCGCGTTCAGAGAGGACTAGAC|CCGCGCGTGTTCGTTGGCTTAGATCTGTTT
GAATTGGTAAGCTTCCGGATCCGATTATAA|GTACTGCGCCTGTGCATCTGGGTTGTCGAT
ATACGTTTTGAGAAAGGCCACTGATTTCTC|AGTAGTAGGGGTGTGGGGTAAAGAGATGAG
AGTAGCTGTTAGATACGTTTTGAGAAAGGC|CCGTATGAAAGGAGTAGTAGGGGTGTGGGG
GATTTCTCTGTGTAGCCTGAGGCCGTGTGA|GAGATGAGCAGGCGTACCGTGTGAGGAGAT
AGATGTGACCATAAGAATTGTTTGAGCTTC|GCCGGCGTTCGTTGTTGAGTTGCAAACTTC
GCCACTGATTTCTCTGTGTAGCCTGAGGCC|GGTAAAGAGATGAGCAGGCGTACCGTGTGA
GCCGTGTGAGGAGATGTGACCATAAGAATT|TGAGGAGATGTGACCATAAGAATTGTTTGA
TCCGTGTGAGGAGATGTGACCATAAGAATT|TGTGACCACCGTGTGAGGAGATGTGACCAT
TACCACCAAGATTTGGGCCCGTGTGAGGAG|TAGGAGAACGACATGGGTTGGAAATTCCGT
AATGACACCGTGATCCCGTGTGAGGAGATG|GAAAGCGAGAGCGGTGATAAGAGAGGCCAT
CGATTATAATAGGCTGGGTATGGTATGCCC|GTTGTCGATCAGTGCCGTCCTCGATTTCAC
ATGTGACCATAAGAATTGTGCGTTTTTGTC|CCATAAGAATTGTTTGAGCTTCCAGGACCA
GTGAGGAGATGTGACCATAAGAATTGCAGC|TATGGTATGCCCACGGTGGCGGCCATACCG
CCATAAGAATTCCGTGTGAGGAGATGTGAC|AGATGTGACCATAAGAATTGATCCGTGTGA
CCGTGTGAGGAGATGTGACCATAAGAATTG|GATAAGAGAGGCCATCTCAAACTTGCAGAC
TGATCCCGTGTGAGGAGATGTGACCATAAG|GCGGTGATAAGAGAGGCCATCTCAAACTTG
AGTTGCAAACTTCAAGTATCACATTGTACC|CATCGCAACGGTATTCGCGTTCAGAGAGGA
TTTCAACGAATCAATCTTTAAATGCCCAGG|TATGTAACCGTGTGAGGAGATGTGACCATA
CCAGGACCAGTAAGAAGGGGACCCCGGGTC|CAAGTATCACATTGTACCAAATCAGTACCA
AAGAAGGGGACCCCGGGTCCATCAAACTAA|TTGTACCAAATCAGTACCACCAAGATTTGG
CGTCGTGTCGTGTTGACCGTATGAAAGGAG|GGGTCCATCAAACTAAGACTGCGCTATCCG
ATTCCGTGTGAGGAGATGTGACCATAAGAA|CCATAAGAATTGATCCGTGTGAGGAGATGT
CCATAAGAATTGGTGAGGAGATGTGACCAT|GATGTGACCATAAGAATTGTAAGAATTGAT
GGTAGAATTATCACTTTTATGTAACCGTGT|CTTCCGGATCCGATTATAATAGGCTGGGTA
CACCAAGATTTGGGCCCGTGTGAGGAGATG|GAGAACGACATGGGTTGGAAATTCCGTGTG
GAAACGTACACGACTGTTATGCTGCACTGC|GATACGTTTTGAGAAAGGCCACTGATTTCT
CTATCCGGTTCCTTTTCGCACCACCGTGTG|TGAGGAGATGTGACCATAAGAATTCCGTGT
TGACCATAAGAATTGTTTGAGCTTCCAGGA|CGTTCGTTGTTGAGTTGCAAACTTCAAGTA
TTACCCGTTCAATCAGTAGCTGTTAGATAC|TCGTGTCGTGTTGACCGTATGAAAGGAGTA
TGTGTACTGCGCCTGTGCATCTGGGTTGTC|AAGAATTGAGACATAGACATTGCCAACACA
TCACATTGTACCAAATCAGTACCACCAAGA|GTTCAGAGAGGACTAGACTTAGGAGAACGA
AGGAGTAGTAGGGGTGTGGGGTAAAGAGAT|ATCCGGTTCCTTTTCGCACCACCGTGTGAG
GATGTGACCATAAGAATTGATCCGTGTGAG|GGATTTGGCCAATCACTAAATGGTTATCAG
ACCATACGGCAACGCTATATGGGCAGGGTA|AACTTACCGTCCGTGTGAGGAGATGTGACC
CGAATGGCCGTCGTGTCGTGTTGACCGTAT|GGGACCCCGGGTCCATCAAACTAAGACTGC
TATGGGCAGGGTATTCCGTGTGAGGAGATG|AGGAGATGTGACCATAAGAATTGGTGAGGA
GGGGTAAAGAGATGAGCAGGCGTACCGTGT|ACCACCGTGTGAGGAGATGTGACCATAAGA
ACCATAAGAATTGCTTACCAATGACACCGT|GTCAGCCTTTGACGACCGCGAAAGCGAGAG
TTGGGCCCGTGTGAGGAGATGTGACCATAA|ATGGGTTGGAAATTCCGTGTGAGGAGATGT
GGCGTGTACCATACGGCAACGCTATATGGG|TGCAGCTAACTTACCGTCCGTGTGAGGAGA
GAGGCCGTGTGAGGAGATGTGACCATAAGA|GTGTGAGGAGATGTGACCATAAGAATTGTT
AGTGAAACGTACACGACTGTTATGCTGCAC|TTAGATACGTTTTGAGAAAGGCCACTGATT
GTAGGGGTGTGGGGTAAAGAGATGAGCAGG|TCCTTTTCGCACCACCGTGTGAGGAGATGT
CAAGATTTGGGCCCGTGTGAGGAGATGTGA|AACGACATGGGTTGGAAATTCCGTGTGAGG
AAATTCCGTGTGAGGAGATGTGACCATAAG|TCCTATAAAAATGAGGGGATTTGGCCAATC
GCGTCCTTTCAACGAATCAATCTTTAAATG|CACTTTTATGTAACCGTGTGAGGAGATGTG
CACATTGTACCAAATCAGTACCACCAAGAT|TTCAGAGAGGACTAGACTTAGGAGAACGAC
TGTGAATCCCTAGCGTTTTTTCCTGTGGTG|TGACCATAAGAATTGAGACACTCCGGTAGA
ATCAGTGCCGTCCTCGATTTCACCTTCCGT|AGAGTGAAACGTACACGACTGTTATGCTGC
CTGTTATGCTGCACTGCGCAACTTTGTCAG|AAAGGCCACTGATTTCTCTGTGTAGCCTGA
TGTGAGGAGATGTGACCATAAGAATTGGTG|ACCACCGTGTGAGGAGATGTGACCATAAGA
AGTAGGGGTGTGGGGTAAAGAGATGAGCAG|TTCCTTTTCGCACCACCGTGTGAGGAGATG
AACTTCAAGTATCACATTGTACCAAATCAG|ACGGTATTCGCGTTCAGAGAGGACTAGACT
CCTTTTCGCACCACCGTGTGAGGAGATGTG|TGACCATAAGAATTCCGTGTGAGGAGATGT
TTTTCCTGTGGTGCAATAGCGTCCTTTCAA|ACACTCCGGTAGAATTATCACTTTTATGTA
AGCTGTTAGATACGTTTTGAGAAAGGCCAC|TATGAAAGGAGTAGTAGGGGTGTGGGGTAA
ATGTGACCATAAGAATTGACCAACTGGCGC|ACCGCAATTCGATTCTGAGGGATGTCGTCT
ATAAGAATTGCAGCTAACTTACCGTCCGTG|TGGCGGCCATACCGTGTGAGGAGATGTGAC
ATTGATGTGTACTGCGCCTGTGCATCTGGG|ACCATAAGAATTGAGACATAGACATTGCCA
AGCGTCCTTTCAACGAATCAATCTTTAAAT|TCACTTTTATGTAACCGTGTGAGGAGATGT
AGGAGATGTGACCATAAGAATTGGCCGGCG|GAGGAGATGTGACCATAAGAATTGGTCGAG
GCGCCGCGCGTGTTCGTTGGCTTAGATCTG|GTCTCTCAGCCGTATGATAAGAAGCCGTGT
TAGACTTAGGAGAACGACATGGGTTGGAAA|TGTTTTTTCCTAGCTGTAACGGGTGGCTCC
CCACTGATTTCTCTGTGTAGCCTGAGGCCG|GTAAAGAGATGAGCAGGCGTACCGTGTGAG
TTTGTCCAATGGTACGAATGGCCGTCGTGT|GGACCAGTAAGAAGGGGACCCCGGGTCCAT
ATGCTGCACTGCGCAACTTTGTCAGCCTTT|CCACTGATTTCTCTGTGTAGCCTGAGGCCG
CAGGCGTACCGTGTGAGGAGATGTGACCAT|ATGTGACCATAAGAATTGGCCGGCGTTCGT
GCTTACCAATGACACCGTGATCCCGTGTGA|CGACCGCGAAAGCGAGAGCGGTGATAAGAG
CAATAGCGTCCTTTCAACGAATCAATCTTT|ATTATCACTTTTATGTAACCGTGTGAGGAG
GGGGACCCCGGGTCCATCAAACTAAGACTG|CCAAATCAGTACCACCAAGATTTGGGCCCG
GTGGCGGCCATACCGTGTGAGGAGATGTGA|CCGTGTGAGGAGATGTGACCATAAGAATTG
CATCTTACCCGTTCAATCAGTAGCTGTTAG|GCCGTCGTGTCGTGTTGACCGTATGAAAGG
AAATCAGTACCACCAAGATTTGGGCCCGTG|CTAGACTTAGGAGAACGACATGGGTTGGAA
AATTGCTTACCAATGACACCGTGATCCCGT|TTGACGACCGCGAAAGCGAGAGCGGTGATA
ACGACATGGGTTGGAAATTCCGTGTGAGGA|CTGTAACGGGTGGCTCCTATAAAAATGAGG
ACATCTTACCCGTTCAATCAGTAGCTGTTA|GGCCGTCGTGTCGTGTTGACCGTATGAAAG
TGAGGAGATGTGACCATAAGAATTGAGACA|GAGAGGCCATCTCAAACTTGCAGACATCTT
CAAGTATCACATTGTACCAAATCAGTACCA|ATTCGCGTTCAGAGAGGACTAGACTTAGGA
ATGACACCGTGATCCCGTGTGAGGAGATGT|AAAGCGAGAGCGGTGATAAGAGAGGCCATC
AGGAGATGTGACCATAAGAATTGACCAACT|AGCGGACCGCAATTCGATTCTGAGGGATGT
TCCGTGTGAGGAGATGTGACCATAAGAATT|ATAAAAATGAGGGGATTTGGCCAATCACTA
CTGATTTCTCTGTGTAGCCTGAGGCCGTGT|AAGAGATGAGCAGGCGTACCGTGTGAGGAG
TGTAGCCTGAGGCCGTGTGAGGAGATGTGA|GGCGTACCGTGTGAGGAGATGTGACCATAA
AATTGATCCGTGTGAGGAGATGTGACCATA|ACTAAATGGTTATCAGCGGACCGCAATTCG
CATCTGGGTTGTCGATCAGTGCCGTCCTCG|CATTGCCAACACACAGAGTGAAACGTACAC
GTGTGAGGAGATGTGACCACCGTGTGAGGA|GTGACCATAAGAATTGCTTACCAATGACAC
TAAGAATTGATGTGTACTGCGCCTGTGCAT|ATGTGACCATAAGAATTGAGACATAGACAT
TTCAAGTATCACATTGTACCAAATCAGTAC|GTATTCGCGTTCAGAGAGGACTAGACTTAG
GAATTATCACTTTTATGTAACCGTGTGAGG|CGGATCCGATTATAATAGGCTGGGTATGGT
GAGACATAGACATTGCCAACACACAGAGTG|CATCTTACCCGTTCAATCAGTAGCTGTTAG
CCGTGTGAGGAGATGTGACCATAAGAATTG|ATAAGAATTGGCCGGCGTTCGTTGTTGAGT
TTCCGGATCCGATTATAATAGGCTGGGTAT|TGCATCTGGGTTGTCGATCAGTGCCGTCCT
TTGAGACATAGACATTGCCAACACACAGAG|GACATCTTACCCGTTCAATCAGTAGCTGTT
CACCTTCCGTGTGAGGAGATGTGACCATAA|GTTATGCTGCACTGCGCAACTTTGTCAGCC
CCTGTGCATCTGGGTTGTCGATCAGTGCCG|CATAGACATTGCCAACACACAGAGTGAAAC
ACCATAAGAATTCCGTGTGAGGAGATGTGA|GAGATGTGACCATAAGAATTGATCCGTGTG
CCGGGTCCATCAAACTAAGACTGCGCTATC|AGTACCACCAAGATTTGGGCCCGTGTGAGG
CTCGATTTCACCTTCCGTGTGAGGAGATGT|ACACGACTGTTATGCTGCACTGCGCAACTT
ACTTGCAGACATCTTACCCGTTCAATCAGT|GTACGAATGGCCGTCGTGTCGTGTTGACCG
GACGACCGCGAAAGCGAGAGCGGTGATAAG|TGTGAGGAGATGTGACCATAAGAATTGTGC
TTTCTCTGTGTAGCCTGAGGCCGTGTGAGG|GATGAGCAGGCGTACCGTGTGAGGAGATGT
AGCTAACTTACCGTCCGTGTGAGGAGATGT|CCGTGTGAGGAGATGTGACCACCGTGTGAG
CAAACTTGCAGACATCTTACCCGTTCAATC|ATGGTACGAATGGCCGTCGTGTCGTGTTGA
TTTGTCAGCCTTTGACGACCGCGAAAGCGA|TAGCCTGAGGCCGTGTGAGGAGATGTGACC
GAGGAGATGTGACCACCGTGTGAGGAGATG|CCATAAGAATTGCTTACCAATGACACCGTG
GAAAGGCCACTGATTTCTCTGTGTAGCCTG|TGTGGGGTAAAGAGATGAGCAGGCGTACCG
ACCATAAGAATTGATCCGTGTGAGGAGATG|GGCCAATCACTAAATGGTTATCAGCGGACC
GAATTGTAAGAATTGATGTGTACTGCGCCT|GAGGAGATGTGACCATAAGAATTGAGACAT
ATAAGAATTGGTAAGCTTCCGGATCCGATT|ATGTGTACTGCGCCTGTGCATCTGGGTTGT
TCCGGTTCCTTTTCGCACCACCGTGTGAGG|GGAGATGTGACCATAAGAATTCCGTGTGAG
GCGAAAGCGAGAGCGGTGATAAGAGAGGCC|AGATGTGACCATAAGAATTGTGCGTTTTTG
GGACCAGTAAGAAGGGGACCCCGGGTCCAT|GTATCACATTGTACCAAATCAGTACCACCA
TTCCTGTGGTGCAATAGCGTCCTTTCAACG|ACTCCGGTAGAATTATCACTTTTATGTAAC
TCTCAAACTTGCAGACATCTTACCCGTTCA|CCAATGGTACGAATGGCCGTCGTGTCGTGT
CCCGGGTCCATCAAACTAAGACTGCGCTAT|CAGTACCACCAAGATTTGGGCCCGTGTGAG
ATCAATCTTTAAATGCCCAGGGAGCCGGCG|GTGTGAGGAGATGTGACCATAAGAATTGCA
GGAGATGTGACCATAAGAATTGCTTACCAA|CGCAACTTTGTCAGCCTTTGACGACCGCGA
TCCATCAAACTAAGACTGCGCTATCCGGTT|CACCAAGATTTGGGCCCGTGTGAGGAGATG
ATGTGACCATAAGAATTGCAGCTAACTTAC|GCCCACGGTGGCGGCCATACCGTGTGAGGA
AGATGTGACCATAAGAATTGAGACATAGAC|GCCATCTCAAACTTGCAGACATCTTACCCG
GGAGATGTGACCATAAGAATTGATCCGTGT|AGGGGATTTGGCCAATCACTAAATGGTTAT
GTGTGAGGAGATGTGACCATAAGAATTGTT|AAGAATTGGCCGGCGTTCGTTGTTGAGTTG
CACCACCGTGTGAGGAGATGTGACCATAAG|AGAATTCCGTGTGAGGAGATGTGACCATAA
GAATTGACCAACTGGCGCCGCGCGTGTTCG|TTCTGAGGGATGTCGTCTCTCAGCCGTATG
GATCCCGTGTGAGGAGATGTGACCATAAGA|CGGTGATAAGAGAGGCCATCTCAAACTTGC
TGACCATAAGAATTGGTCGAGCGATAGGGG|GTGAGGAGATGTGACCATAAGAATTGACCA
AGATGTGACCATAAGAATTGGTCGAGCGAT|TCCGTGTGAGGAGATGTGACCATAAGAATT
CGCACCACCGTGTGAGGAGATGTGACCATA|TAAGAATTCCGTGTGAGGAGATGTGACCAT
AGATGTGACCATAAGAATTGATCCGTGTGA|GGGATTTGGCCAATCACTAAATGGTTATCA
AGACATAGACATTGCCAACACACAGAGTGA|ATCTTACCCGTTCAATCAGTAGCTGTTAGA
GCTGCACTGCGCAACTTTGTCAGCCTTTGA|ACTGATTTCTCTGTGTAGCCTGAGGCCGTG
CTGTGGTGCAATAGCGTCCTTTCAACGAAT|CCGGTAGAATTATCACTTTTATGTAACCGT
GAATTGAGACACTCCGGTAGAATTATCACT|ATAAGAATTGGTAAGCTTCCGGATCCGATT
AATTGGTGAGGAGATGTGACCATAAGAATT|CCATAAGAATTGTAAGAATTGATGTGTACT
ATGGTACGAATGGCCGTCGTGTCGTGTTGA|AAGAAGGGGACCCCGGGTCCATCAAACTAA
GTGTGAGGAGATGTGACCATAAGAATTGAC|TTATCAGCGGACCGCAATTCGATTCTGAGG
AGACTTAGGAGAACGACATGGGTTGGAAAT|GTTTTTTCCTAGCTGTAACGGGTGGCTCCT
TAAGAGAGGCCATCTCAAACTTGCAGACAT|GTGCGTTTTTGTCCAATGGTACGAATGGCC
ACTAGACTTAGGAGAACGACATGGGTTGGA|TCTGTTTTTTCCTAGCTGTAACGGGTGGCT
ATGGGCAGGGTATTCCGTGTGAGGAGATGT|GGAGATGTGACCATAAGAATTGGTGAGGAG
GGCCGGCGTTCGTTGTTGAGTTGCAAACTT|TGGTCGAGCGATAGGGGCCATCGCAACGGT
GACCATAAGAATTGGTGAGGAGATGTGACC|GAGATGTGACCATAAGAATTGTAAGAATTG
TGACCATAAGAATTGGTGAGGAGATGTGAC|GGAGATGTGACCATAAGAATTGTAAGAATT
CTTTGTCAGCCTTTGACGACCGCGAAAGCG|GTAGCCTGAGGCCGTGTGAGGAGATGTGAC
TGAGGAGATGTGACCATAAGAATTGTTTGA|AATTGGCCGGCGTTCGTTGTTGAGTTGCAA
ATGGTATGCCCACGGTGGCGGCCATACCGT|CTCGATTTCACCTTCCGTGTGAGGAGATGT
GACCATAAGAATTGGTCGAGCGATAGGGGC|TGAGGAGATGTGACCATAAGAATTGACCAA
TAAGAATTGCAGCTAACTTACCGTCCGTGT|GGCGGCCATACCGTGTGAGGAGATGTGACC
TCCCGTGTGAGGAGATGTGACCATAAGAAT|GTGATAAGAGAGGCCATCTCAAACTTGCAG
TGTCGATCAGTGCCGTCCTCGATTTCACCT|CACACAGAGTGAAACGTACACGACTGTTAT
GAATTCCGTGTGAGGAGATGTGACCATAAG|GACCATAAGAATTGATCCGTGTGAGGAGAT
GTCCTTTCAACGAATCAATCTTTAAATGCC|CTTTTATGTAACCGTGTGAGGAGATGTGAC
CCATCGCAACGGTATTCGCGTTCAGAGAGG|ACTGGCGCCGCGCGTGTTCGTTGGCTTAGA
AAACTAAGACTGCGCTATCCGGTTCCTTTT|GATTTGGGCCCGTGTGAGGAGATGTGACCA
CGTTTTGAGAAAGGCCACTGATTTCTCTGT|AGTAGGGGTGTGGGGTAAAGAGATGAGCAG
TTGACGACCGCGAAAGCGAGAGCGGTGATA|CGTGTGAGGAGATGTGACCATAAGAATTGT
GATGTGACCATAAGAATTCCGTGTGAGGAG|TGTGAGGAGATGTGACCATAAGAATTGATC
TGTAACCGTGTGAGGAGATGTGACCATAAG|TAGGCTGGGTATGGTATGCCCACGGTGGCG
TGATGTGTACTGCGCCTGTGCATCTGGGTT|CATAAGAATTGAGACATAGACATTGCCAAC
TCCGTGTGAGGAGATGTGACCATAAGAATT|GCTGCACTGCGCAACTTTGTCAGCCTTTGA
GGCCGTCGTGTCGTGTTGACCGTATGAAAG|CCCGGGTCCATCAAACTAAGACTGCGCTAT
CCATCTCAAACTTGCAGACATCTTACCCGT|TGTCCAATGGTACGAATGGCCGTCGTGTCG
GCCCGTGTGAGGAGATGTGACCATAAGAAT|GTTGGAAATTCCGTGTGAGGAGATGTGACC
CAAACTTCAAGTATCACATTGTACCAAATC|CAACGGTATTCGCGTTCAGAGAGGACTAGA
ATTGCTTACCAATGACACCGTGATCCCGTG|TGACGACCGCGAAAGCGAGAGCGGTGATAA
CGTTCAGAGAGGACTAGACTTAGGAGAACG|CGTTGGCTTAGATCTGTTTTTTCCTAGCTG
ATTGACCAACTGGCGCCGCGCGTGTTCGTT|CTGAGGGATGTCGTCTCTCAGCCGTATGAT
GTATGAAAGGAGTAGTAGGGGTGTGGGGTA|CTGCGCTATCCGGTTCCTTTTCGCACCACC
TTGAGACACTCCGGTAGAATTATCACTTTT|AGAATTGGTAAGCTTCCGGATCCGATTATA
GATGTGACCATAAGAATTGGTAAGCTTCCG|TAAGAATTGATGTGTACTGCGCCTGTGCAT
TAAGAATTGGCCGGCGTTCGTTGTTGAGTT|ATAAGAATTGGTCGAGCGATAGGGGCCATC
AGATGTGACCATAAGAATTCCGTGTGAGGA|GTGTGAGGAGATGTGACCATAAGAATTGAT
CCGTGTGAGGAGATGTGACCATAAGAATTG|TAAGAATTGATCCGTGTGAGGAGATGTGAC
CATCGCAACGGTATTCGCGTTCAGAGAGGA|CTGGCGCCGCGCGTGTTCGTTGGCTTAGAT
TGTACCAAATCAGTACCACCAAGATTTGGG|AGAGGACTAGACTTAGGAGAACGACATGGG
TGAGAAAGGCCACTGATTTCTCTGTGTAGC|GGGTGTGGGGTAAAGAGATGAGCAGGCGTA
GTGACCATAAGAATTGCTTACCAATGACAC|TTTGTCAGCCTTTGACGACCGCGAAAGCGA
GTGAGGAGATGTGACCACCGTGTGAGGAGA|GACCATAAGAATTGCTTACCAATGACACCG
GTAAGAATTGATGTGTACTGCGCCTGTGCA|GATGTGACCATAAGAATTGAGACATAGACA
ACTTAGGAGAACGACATGGGTTGGAAATTC|TTTTTCCTAGCTGTAACGGGTGGCTCCTAT
ATCTTACCCGTTCAATCAGTAGCTGTTAGA|CCGTCGTGTCGTGTTGACCGTATGAAAGGA
GTATGCCCACGGTGGCGGCCATACCGTGTG|GATTTCACCTTCCGTGTGAGGAGATGTGAC
CATAAGAATTGAGACACTCCGGTAGAATTA|TGACCATAAGAATTGGTAAGCTTCCGGATC
GAGATGTGACCATAAGAATTGCTTACCAAT|GCAACTTTGTCAGCCTTTGACGACCGCGAA
TGACCATAAGAATTGCAGCTAACTTACCGT|CACGGTGGCGGCCATACCGTGTGAGGAGAT
GTGACCATAAGAATTCCGTGTGAGGAGATG|GAGGAGATGTGACCATAAGAATTGATCCGT
TGTGAGGAGATGTGACCATAAGAATTGATC|AAATGAGGGGATTTGGCCAATCACTAAATG
GAGATGTGACCATAAGAATTGATCCGTGTG|GGGGATTTGGCCAATCACTAAATGGTTATC
TGTTAGATACGTTTTGAGAAAGGCCACTGA|GAAAGGAGTAGTAGGGGTGTGGGGTAAAGA
GCACTGCGCAACTTTGTCAGCCTTTGACGA|GATTTCTCTGTGTAGCCTGAGGCCGTGTGA
GAGATGAGCAGGCGTACCGTGTGAGGAGAT|GTGAGGAGATGTGACCATAAGAATTGGCCG
GTGTACCATACGGCAACGCTATATGGGCAG|AGCTAACTTACCGTCCGTGTGAGGAGATGT
GGGAGCCGGCGTGTACCATACGGCAACGCT|TAAGAATTGCAGCTAACTTACCGTCCGTGT
AGCCTGAGGCCGTGTGAGGAGATGTGACCA|GTACCGTGTGAGGAGATGTGACCATAAGAA
TTATGTAACCGTGTGAGGAGATGTGACCAT|TAATAGGCTGGGTATGGTATGCCCACGGTG
TTGCAGACATCTTACCCGTTCAATCAGTAG|ACGAATGGCCGTCGTGTCGTGTTGACCGTA
AAGAGATGAGCAGGCGTACCGTGTGAGGAG|GTGTGAGGAGATGTGACCATAAGAATTGGC
TGTGACCATAAGAATTGCAGCTAACTTACC|CCCACGGTGGCGGCCATACCGTGTGAGGAG
TAGGGGTGTGGGGTAAAGAGATGAGCAGGC|CCTTTTCGCACCACCGTGTGAGGAGATGTG
GGTGGCGGCCATACCGTGTGAGGAGATGTG|TCCGTGTGAGGAGATGTGACCATAAGAATT
ACCAACTGGCGCCGCGCGTGTTCGTTGGCT|GGGATGTCGTCTCTCAGCCGTATGATAAGA
ATTTCTCTGTGTAGCCTGAGGCCGTGTGAG|AGATGAGCAGGCGTACCGTGTGAGGAGATG
ATGCCCAGGGAGCCGGCGTGTACCATACGG|GTGACCATAAGAATTGCAGCTAACTTACCG
TAACCGTGTGAGGAGATGTGACCATAAGAA|GGCTGGGTATGGTATGCCCACGGTGGCGGC
TATGGTATGCCCACGGTGGCGGCCATACCG|CCTCGATTTCACCTTCCGTGTGAGGAGATG
GGAGATGTGACCATAAGAATTGTTTGAGCT|TGGCCGGCGTTCGTTGTTGAGTTGCAAACT
GTTCAGAGAGGACTAGACTTAGGAGAACGA|GTTGGCTTAGATCTGTTTTTTCCTAGCTGT
AGAGCGGTGATAAGAGAGGCCATCTCAAAC|CATAAGAATTGTGCGTTTTTGTCCAATGGT
GTGAGGAGATGTGACCATAAGAATTGCTTA|ACTGCGCAACTTTGTCAGCCTTTGACGACC
ATTGGTCGAGCGATAGGGGCCATCGCAACG|TGACCATAAGAATTGACCAACTGGCGCCGC
AGCTTCCAGGACCAGTAAGAAGGGGACCCC|AACTTCAAGTATCACATTGTACCAAATCAG
TGCGTTTTTGTCCAATGGTACGAATGGCCG|CTTCCAGGACCAGTAAGAAGGGGACCCCGG
GAGCCGGCGTGTACCATACGGCAACGCTAT|AGAATTGCAGCTAACTTACCGTCCGTGTGA
TGCTTACCAATGACACCGTGATCCCGTGTG|ACGACCGCGAAAGCGAGAGCGGTGATAAGA
AATCTTTAAATGCCCAGGGAGCCGGCGTGT|TGAGGAGATGTGACCATAAGAATTGCAGCT
GACCATAAGAATTGGTAAGCTTCCGGATCC|ATTGATGTGTACTGCGCCTGTGCATCTGGG
TTTTCGCACCACCGTGTGAGGAGATGTGAC|ACCATAAGAATTCCGTGTGAGGAGATGTGA
ACCTTCCGTGTGAGGAGATGTGACCATAAG|TTATGCTGCACTGCGCAACTTTGTCAGCCT
AAGAATTGACCAACTGGCGCCGCGCGTGTT|GATTCTGAGGGATGTCGTCTCTCAGCCGTA
ATAAGAATTGATCCGTGTGAGGAGATGTGA|CAATCACTAAATGGTTATCAGCGGACCGCA
GATGTGACCATAAGAATTGACCAACTGGCG|GACCGCAATTCGATTCTGAGGGATGTCGTC
CGTCCTTTCAACGAATCAATCTTTAAATGC|ACTTTTATGTAACCGTGTGAGGAGATGTGA
CCGTGTGAGGAGATGTGACCATAAGAATTG|CTGCACTGCGCAACTTTGTCAGCCTTTGAC
TGGCCGGCGTTCGTTGTTGAGTTGCAAACT|TTGGTCGAGCGATAGGGGCCATCGCAACGG
TCCGTGTGAGGAGATGTGACCATAAGAATT|ATAAGAATTGATCCGTGTGAGGAGATGTGA
ATTCGCGTTCAGAGAGGACTAGACTTAGGA|GTGTTCGTTGGCTTAGATCTGTTTTTTCCT
TGTGGGGTAAAGAGATGAGCAGGCGTACCG|CGCACCACCGTGTGAGGAGATGTGACCATA
CAGTAAGAAGGGGACCCCGGGTCCATCAAA|CACATTGTACCAAATCAGTACCACCAAGAT
AGGAGATGTGACCATAAGAATTGTAAGAAT|ACACCGTGATCCCGTGTGAGGAGATGTGAC
TAATAGGCTGGGTATGGTATGCCCACGGTG|GATCAGTGCCGTCCTCGATTTCACCTTCCG
TGAGACACTCCGGTAGAATTATCACTTTTA|GAATTGGTAAGCTTCCGGATCCGATTATAA
GAGCGGTGATAAGAGAGGCCATCTCAAACT|ATAAGAATTGTGCGTTTTTGTCCAATGGTA
GGAGATGTGACCATAAGAATTGTAAGAATT|CACCGTGATCCCGTGTGAGGAGATGTGACC
GTGCATCTGGGTTGTCGATCAGTGCCGTCC|AGACATTGCCAACACACAGAGTGAAACGTA
TGTTTGAGCTTCCAGGACCAGTAAGAAGGG|GTTGCAAACTTCAAGTATCACATTGTACCA
ATAAGAATTGTAAGAATTGATGTGTACTGC|GTGTGAGGAGATGTGACCATAAGAATTGAG
GCGCTATCCGGTTCCTTTTCGCACCACCGT|GTGTGAGGAGATGTGACCATAAGAATTCCG
ATTGTACCAAATCAGTACCACCAAGATTTG|AGAGAGGACTAGACTTAGGAGAACGACATG
CCGTGTGAGGAGATGTGACCATAAGAATTC|TGGAAATTCCGTGTGAGGAGATGTGACCAT
ATGTGACCATAAGAATTCCGTGTGAGGAGA|GTGAGGAGATGTGACCATAAGAATTGATCC
GAGCTTCCAGGACCAGTAAGAAGGGGACCC|AAACTTCAAGTATCACATTGTACCAAATCA
GGAGATGTGACCATAAGAATTGCAGCTAAC|GTATGCCCACGGTGGCGGCCATACCGTGTG
AGAGGACTAGACTTAGGAGAACGACATGGG|TTAGATCTGTTTTTTCCTAGCTGTAACGGG
ACTGATTTCTCTGTGTAGCCTGAGGCCGTG|AAAGAGATGAGCAGGCGTACCGTGTGAGGA
TGAAAGGAGTAGTAGGGGTGTGGGGTAAAG|CGCTATCCGGTTCCTTTTCGCACCACCGTG
GGACCCCGGGTCCATCAAACTAAGACTGCG|AAATCAGTACCACCAAGATTTGGGCCCGTG
GTCCATCAAACTAAGACTGCGCTATCCGGT|CCACCAAGATTTGGGCCCGTGTGAGGAGAT
GATCCGATTATAATAGGCTGGGTATGGTAT|CTGGGTTGTCGATCAGTGCCGTCCTCGATT
TTCCGTGTGAGGAGATGTGACCATAAGAAT|TGCTGCACTGCGCAACTTTGTCAGCCTTTG
TGCACTGCGCAACTTTGTCAGCCTTTGACG|TGATTTCTCTGTGTAGCCTGAGGCCGTGTG
GGCGTACCGTGTGAGGAGATGTGACCATAA|GTGACCATAAGAATTGGCCGGCGTTCGTTG
CTGTGCATCTGGGTTGTCGATCAGTGCCGT|ATAGACATTGCCAACACACAGAGTGAAACG
GGCAACGCTATATGGGCAGGGTATTCCGTG|CGTCCGTGTGAGGAGATGTGACCATAAGAA
GACCATAAGAATTCCGTGTGAGGAGATGTG|GGAGATGTGACCATAAGAATTGATCCGTGT
TTGGTGAGGAGATGTGACCATAAGAATTGG|ATAAGAATTGTAAGAATTGATGTGTACTGC
GGTATGCCCACGGTGGCGGCCATACCGTGT|CGATTTCACCTTCCGTGTGAGGAGATGTGA
CGACATGGGTTGGAAATTCCGTGTGAGGAG|TGTAACGGGTGGCTCCTATAAAAATGAGGG
GGTCCATCAAACTAAGACTGCGCTATCCGG|ACCACCAAGATTTGGGCCCGTGTGAGGAGA
AATTGTGCGTTTTTGTCCAATGGTACGAAT|TTGAGCTTCCAGGACCAGTAAGAAGGGGAC
AAGAATTGTTTGAGCTTCCAGGACCAGTAA|TGTTGAGTTGCAAACTTCAAGTATCACATT
ACTGTTATGCTGCACTGCGCAACTTTGTCA|GAAAGGCCACTGATTTCTCTGTGTAGCCTG
TAGCGTCCTTTCAACGAATCAATCTTTAAA|ATCACTTTTATGTAACCGTGTGAGGAGATG
GCGTTCGTTGTTGAGTTGCAAACTTCAAGT|GAGCGATAGGGGCCATCGCAACGGTATTCG
CCATAAGAATTGATCCGTGTGAGGAGATGT|GCCAATCACTAAATGGTTATCAGCGGACCG
TAGGCTGGGTATGGTATGCCCACGGTGGCG|CAGTGCCGTCCTCGATTTCACCTTCCGTGT
CGTTTTTGTCCAATGGTACGAATGGCCGTC|TCCAGGACCAGTAAGAAGGGGACCCCGGGT
CATAGACATTGCCAACACACAGAGTGAAAC|TTACCCGTTCAATCAGTAGCTGTTAGATAC
GCCGTCGTGTCGTGTTGACCGTATGAAAGG|CCGGGTCCATCAAACTAAGACTGCGCTATC
ACCGTGTGAGGAGATGTGACCATAAGAATT|CTGGGTATGGTATGCCCACGGTGGCGGCCA
GTGTACTGCGCCTGTGCATCTGGGTTGTCG|AGAATTGAGACATAGACATTGCCAACACAC
CGATCAGTGCCGTCCTCGATTTCACCTTCC|ACAGAGTGAAACGTACACGACTGTTATGCT
ATAAGAATTCCGTGTGAGGAGATGTGACCA|ATGTGACCATAAGAATTGATCCGTGTGAGG
ACGCTATATGGGCAGGGTATTCCGTGTGAG|CGTGTGAGGAGATGTGACCATAAGAATTGG
TGCAAACTTCAAGTATCACATTGTACCAAA|CGCAACGGTATTCGCGTTCAGAGAGGACTA
TAAGAATTGATCCGTGTGAGGAGATGTGAC|AATCACTAAATGGTTATCAGCGGACCGCAA
GTGATAAGAGAGGCCATCTCAAACTTGCAG|AATTGTGCGTTTTTGTCCAATGGTACGAAT
AGGACTAGACTTAGGAGAACGACATGGGTT|AGATCTGTTTTTTCCTAGCTGTAACGGGTG
GGGTGTGGGGTAAAGAGATGAGCAGGCGTA|TTTCGCACCACCGTGTGAGGAGATGTGACC
CAACTGGCGCCGCGCGTGTTCGTTGGCTTA|GATGTCGTCTCTCAGCCGTATGATAAGAAG
CATAAGAATTGGCCGGCGTTCGTTGTTGAG|CCATAAGAATTGGTCGAGCGATAGGGGCCA
AGATTTGGGCCCGTGTGAGGAGATGTGACC|CGACATGGGTTGGAAATTCCGTGTGAGGAG
CCGTCCGTGTGAGGAGATGTGACCATAAGA|AGATGTGACCACCGTGTGAGGAGATGTGAC
TAAGAATTGAGACATAGACATTGCCAACAC|CTTGCAGACATCTTACCCGTTCAATCAGTA
GAGGAGATGTGACCATAAGAATTGGCCGGC|TGAGGAGATGTGACCATAAGAATTGGTCGA
AAGAGAGGCCATCTCAAACTTGCAGACATC|TGCGTTTTTGTCCAATGGTACGAATGGCCG
AGGAGATGTGACCATAAGAATTGGTCGAGC|TGATCCGTGTGAGGAGATGTGACCATAAGA
CGTGTGAGGAGATGTGACCATAAGAATTGT|AGGAGATGTGACCATAAGAATTGTTTGAGC
TCTGGGTTGTCGATCAGTGCCGTCCTCGAT|TTGCCAACACACAGAGTGAAACGTACACGA
ACCGTGTGAGGAGATGTGACCACCGTGTGA|GATGTGACCATAAGAATTGCTTACCAATGA
TGCGCAACTTTGTCAGCCTTTGACGACCGC|TCTCTGTGTAGCCTGAGGCCGTGTGAGGAG
GCATCTGGGTTGTCGATCAGTGCCGTCCTC|ACATTGCCAACACACAGAGTGAAACGTACA
TAAGAATTGGTCGAGCGATAGGGGCCATCG|AGATGTGACCATAAGAATTGACCAACTGGC
AGGGGTGTGGGGTAAAGAGATGAGCAGGCG|CTTTTCGCACCACCGTGTGAGGAGATGTGA
AGGAGAACGACATGGGTTGGAAATTCCGTG|TCCTAGCTGTAACGGGTGGCTCCTATAAAA
TGTGACCATAAGAATTGACCAACTGGCGCC|CCGCAATTCGATTCTGAGGGATGTCGTCTC
ATTGAGACACTCCGGTAGAATTATCACTTT|AAGAATTGGTAAGCTTCCGGATCCGATTAT
ATAAGAATTGTGCGTTTTTGTCCAATGGTA|ATTGTTTGAGCTTCCAGGACCAGTAAGAAG
GTGACCATAAGAATTGTGCGTTTTTGTCCA|ATAAGAATTGTTTGAGCTTCCAGGACCAGT
ACTTTTATGTAACCGTGTGAGGAGATGTGA|ATTATAATAGGCTGGGTATGGTATGCCCAC
ATAAGAATTGGTCGAGCGATAGGGGCCATC|GAGATGTGACCATAAGAATTGACCAACTGG
CTGCGCAACTTTGTCAGCCTTTGACGACCG|TTCTCTGTGTAGCCTGAGGCCGTGTGAGGA
TAAGAATTCCGTGTGAGGAGATGTGACCAT|TGTGACCATAAGAATTGATCCGTGTGAGGA
AGGCTGGGTATGGTATGCCCACGGTGGCGG|AGTGCCGTCCTCGATTTCACCTTCCGTGTG
ACGACCGCGAAAGCGAGAGCGGTGATAAGA|GTGAGGAGATGTGACCATAAGAATTGTGCG
AGCGATAGGGGCCATCGCAACGGTATTCGC|AGAATTGACCAACTGGCGCCGCGCGTGTTC
TCAATCAGTAGCTGTTAGATACGTTTTGAG|TGTTGACCGTATGAAAGGAGTAGTAGGGGT
ATTGCCAACACACAGAGTGAAACGTACACG|TTCAATCAGTAGCTGTTAGATACGTTTTGA
GACCGCGAAAGCGAGAGCGGTGATAAGAGA|GAGGAGATGTGACCATAAGAATTGTGCGTT
TCGTGTCGTGTTGACCGTATGAAAGGAGTA|GTCCATCAAACTAAGACTGCGCTATCCGGT
CCACGGTGGCGGCCATACCGTGTGAGGAGA|ACCTTCCGTGTGAGGAGATGTGACCATAAG
GTAGTAGGGGTGTGGGGTAAAGAGATGAGC|GGTTCCTTTTCGCACCACCGTGTGAGGAGA
GCCCAGGGAGCCGGCGTGTACCATACGGCA|GACCATAAGAATTGCAGCTAACTTACCGTC
GTTCGTTGTTGAGTTGCAAACTTCAAGTAT|GCGATAGGGGCCATCGCAACGGTATTCGCG
GTGGTGCAATAGCGTCCTTTCAACGAATCA|GGTAGAATTATCACTTTTATGTAACCGTGT
AAGGAGTAGTAGGGGTGTGGGGTAAAGAGA|TATCCGGTTCCTTTTCGCACCACCGTGTGA
ACCATAAGAATTGACCAACTGGCGCCGCGC|AATTCGATTCTGAGGGATGTCGTCTCTCAG
TTGTACCAAATCAGTACCACCAAGATTTGG|GAGAGGACTAGACTTAGGAGAACGACATGG
GACATCTTACCCGTTCAATCAGTAGCTGTT|TGGCCGTCGTGTCGTGTTGACCGTATGAAA
CAATGACACCGTGATCCCGTGTGAGGAGAT|CGAAAGCGAGAGCGGTGATAAGAGAGGCCA
TGCAGCTAACTTACCGTCCGTGTGAGGAGA|ATACCGTGTGAGGAGATGTGACCACCGTGT
TTACCAATGACACCGTGATCCCGTGTGAGG|ACCGCGAAAGCGAGAGCGGTGATAAGAGAG
GTCGTGTTGACCGTATGAAAGGAGTAGTAG|ATCAAACTAAGACTGCGCTATCCGGTTCCT
TCCTTTTCGCACCACCGTGTGAGGAGATGT|GTGACCATAAGAATTCCGTGTGAGGAGATG
GCCATCGCAACGGTATTCGCGTTCAGAGAG|AACTGGCGCCGCGCGTGTTCGTTGGCTTAG
ACCAAATCAGTACCACCAAGATTTGGGCCC|GGACTAGACTTAGGAGAACGACATGGGTTG
TCCAATGGTACGAATGGCCGTCGTGTCGTG|CAGTAAGAAGGGGACCCCGGGTCCATCAAA
GCCATCTCAAACTTGCAGACATCTTACCCG|TTGTCCAATGGTACGAATGGCCGTCGTGTC
AATTGTTTGAGCTTCCAGGACCAGTAAGAA|TGAGTTGCAAACTTCAAGTATCACATTGTA
AGGGGACCCCGGGTCCATCAAACTAAGACT|ACCAAATCAGTACCACCAAGATTTGGGCCC
ATGAGCAGGCGTACCGTGTGAGGAGATGTG|AGGAGATGTGACCATAAGAATTGGCCGGCG
GAATTGATGTGTACTGCGCCTGTGCATCTG|TGACCATAAGAATTGAGACATAGACATTGC
CATAAGAATTGTTTGAGCTTCCAGGACCAG|CGTTGTTGAGTTGCAAACTTCAAGTATCAC
TATCACTTTTATGTAACCGTGTGAGGAGAT|TCCGATTATAATAGGCTGGGTATGGTATGC
ATCCGTGTGAGGAGATGTGACCATAAGAAT|ATGGTTATCAGCGGACCGCAATTCGATTCT
CCTAGCGTTTTTTCCTGTGGTGCAATAGCG|AGAATTGAGACACTCCGGTAGAATTATCAC
AGAATTGTTTGAGCTTCCAGGACCAGTAAG|GTTGAGTTGCAAACTTCAAGTATCACATTG
CGGCGTTCGTTGTTGAGTTGCAAACTTCAA|TCGAGCGATAGGGGCCATCGCAACGGTATT
GACTTAGGAGAACGACATGGGTTGGAAATT|TTTTTTCCTAGCTGTAACGGGTGGCTCCTA
GAATTGCTTACCAATGACACCGTGATCCCG|TTTGACGACCGCGAAAGCGAGAGCGGTGAT
CAATCTTTAAATGCCCAGGGAGCCGGCGTG|GTGAGGAGATGTGACCATAAGAATTGCAGC
TTGCAGCTAACTTACCGTCCGTGTGAGGAG|CATACCGTGTGAGGAGATGTGACCACCGTG
GGACTAGACTTAGGAGAACGACATGGGTTG|GATCTGTTTTTTCCTAGCTGTAACGGGTGG
GTTGAGTTGCAAACTTCAAGTATCACATTG|GGGCCATCGCAACGGTATTCGCGTTCAGAG
AGACTGCGCTATCCGGTTCCTTTTCGCACC|GGCCCGTGTGAGGAGATGTGACCATAAGAA
GAATTGTGCGTTTTTGTCCAATGGTACGAA|TTTGAGCTTCCAGGACCAGTAAGAAGGGGA
CGTGTGAGGAGATGTGACCATAAGAATTGG|TGACCACCGTGTGAGGAGATGTGACCATAA
TCTCTGTGTAGCCTGAGGCCGTGTGAGGAG|TGAGCAGGCGTACCGTGTGAGGAGATGTGA
GAGACACTCCGGTAGAATTATCACTTTTAT|AATTGGTAAGCTTCCGGATCCGATTATAAT
GACCATAAGAATTGACCAACTGGCGCCGCG|CAATTCGATTCTGAGGGATGTCGTCTCTCA
ATTCCGTGTGAGGAGATGTGACCATAAGAA|CATAAGAATTGGTGAGGAGATGTGACCATA
CTAACTTACCGTCCGTGTGAGGAGATGTGA|GTGTGAGGAGATGTGACCACCGTGTGAGGA
GAATTGATCCGTGTGAGGAGATGTGACCAT|CACTAAATGGTTATCAGCGGACCGCAATTC
TAAGAATTGGTGAGGAGATGTGACCATAAG|GTGACCATAAGAATTGTAAGAATTGATGTG
GTGAATCCCTAGCGTTTTTTCCTGTGGTGC|GACCATAAGAATTGAGACACTCCGGTAGAA
GGGTATGGTATGCCCACGGTGGCGGCCATA|CGTCCTCGATTTCACCTTCCGTGTGAGGAG
ATACGGCAACGCTATATGGGCAGGGTATTC|TTACCGTCCGTGTGAGGAGATGTGACCATA
CGCAACGGTATTCGCGTTCAGAGAGGACTA|GCGCCGCGCGTGTTCGTTGGCTTAGATCTG
TGTGAGGAGATGTGACCATAAGAATTGAGA|AATTGGTGAGGAGATGTGACCATAAGAATT
TTGTCCAATGGTACGAATGGCCGTCGTGTC|GACCAGTAAGAAGGGGACCCCGGGTCCATC
GTGTGAGGAGATGTGACCATAAGAATTGTA|CAATGACACCGTGATCCCGTGTGAGGAGAT
TTTTTTCCTGTGGTGCAATAGCGTCCTTTC|AGACACTCCGGTAGAATTATCACTTTTATG
AAACGTACACGACTGTTATGCTGCACTGCG|ATACGTTTTGAGAAAGGCCACTGATTTCTC
AAGAATTGGTGAGGAGATGTGACCATAAGA|TGACCATAAGAATTGTAAGAATTGATGTGT
AGAATTGGTGAGGAGATGTGACCATAAGAA|GACCATAAGAATTGTAAGAATTGATGTGTA
TACCGTGTGAGGAGATGTGACCACCGTGTG|AGATGTGACCATAAGAATTGCTTACCAATG
CTTCCGTGTGAGGAGATGTGACCATAAGAA|ATGCTGCACTGCGCAACTTTGTCAGCCTTT
GATGTGACCATAAGAATTGCTTACCAATGA|AACTTTGTCAGCCTTTGACGACCGCGAAAG
GAGGACTAGACTTAGGAGAACGACATGGGT|TAGATCTGTTTTTTCCTAGCTGTAACGGGT
AGAATTGCTTACCAATGACACCGTGATCCC|CTTTGACGACCGCGAAAGCGAGAGCGGTGA
GGAGCCGGCGTGTACCATACGGCAACGCTA|AAGAATTGCAGCTAACTTACCGTCCGTGTG
TGGAAATTCCGTGTGAGGAGATGTGACCAT|GGCTCCTATAAAAATGAGGGGATTTGGCCA
TACCCGTTCAATCAGTAGCTGTTAGATACG|CGTGTCGTGTTGACCGTATGAAAGGAGTAG
GCGCCTGTGCATCTGGGTTGTCGATCAGTG|AGACATAGACATTGCCAACACACAGAGTGA
GACCATAAGAATTGAGACATAGACATTGCC|TCAAACTTGCAGACATCTTACCCGTTCAAT
CATCAAACTAAGACTGCGCTATCCGGTTCC|CCAAGATTTGGGCCCGTGTGAGGAGATGTG
GCAATAGCGTCCTTTCAACGAATCAATCTT|AATTATCACTTTTATGTAACCGTGTGAGGA
AGCCTTTGACGACCGCGAAAGCGAGAGCGG|GAGGCCGTGTGAGGAGATGTGACCATAAGA
GACCATAAGAATTGTTTGAGCTTCCAGGAC|GTTCGTTGTTGAGTTGCAAACTTCAAGTAT
CAGACATCTTACCCGTTCAATCAGTAGCTG|AATGGCCGTCGTGTCGTGTTGACCGTATGA
AAGCGAGAGCGGTGATAAGAGAGGCCATCT|GTGACCATAAGAATTGTGCGTTTTTGTCCA
TAAGACTGCGCTATCCGGTTCCTTTTCGCA|TGGGCCCGTGTGAGGAGATGTGACCATAAG
TTGACCGTATGAAAGGAGTAGTAGGGGTGT|CTAAGACTGCGCTATCCGGTTCCTTTTCGC
TCCTTTCAACGAATCAATCTTTAAATGCCC|TTTTATGTAACCGTGTGAGGAGATGTGACC
ATCACTTTTATGTAACCGTGTGAGGAGATG|CCGATTATAATAGGCTGGGTATGGTATGCC
GTGACCATAAGAATTGATCCGTGTGAGGAG|TTTGGCCAATCACTAAATGGTTATCAGCGG
AAAGAGATGAGCAGGCGTACCGTGTGAGGA|CGTGTGAGGAGATGTGACCATAAGAATTGG
GAGAACGACATGGGTTGGAAATTCCGTGTG|CTAGCTGTAACGGGTGGCTCCTATAAAAAT
GACTAGACTTAGGAGAACGACATGGGTTGG|ATCTGTTTTTTCCTAGCTGTAACGGGTGGC
GTGAGGAGATGTGACCATAAGAATTGGTGA|CCACCGTGTGAGGAGATGTGACCATAAGAA
CCCCGGGTCCATCAAACTAAGACTGCGCTA|TCAGTACCACCAAGATTTGGGCCCGTGTGA
GGCTGGGTATGGTATGCCCACGGTGGCGGC|GTGCCGTCCTCGATTTCACCTTCCGTGTGA
GTAGCCTGAGGCCGTGTGAGGAGATGTGAC|GCGTACCGTGTGAGGAGATGTGACCATAAG
ATAAGAGAGGCCATCTCAAACTTGCAGACA|TGTGCGTTTTTGTCCAATGGTACGAATGGC
TGAGGAGATGTGACCATAAGAATTGGTGAG|CACCGTGTGAGGAGATGTGACCATAAGAAT
ACCATAAGAATTGAGACATAGACATTGCCA|CAAACTTGCAGACATCTTACCCGTTCAATC
CTTACCAATGACACCGTGATCCCGTGTGAG|GACCGCGAAAGCGAGAGCGGTGATAAGAGA
GGCCATCTCAAACTTGCAGACATCTTACCC|TTTGTCCAATGGTACGAATGGCCGTCGTGT
TGACACCGTGATCCCGTGTGAGGAGATGTG|AAGCGAGAGCGGTGATAAGAGAGGCCATCT
CGGCCATACCGTGTGAGGAGATGTGACCAC|GTGAGGAGATGTGACCATAAGAATTGCTTA
GTTCCTTTTCGCACCACCGTGTGAGGAGAT|ATGTGACCATAAGAATTCCGTGTGAGGAGA
GCTATATGGGCAGGGTATTCCGTGTGAGGA|TGTGAGGAGATGTGACCATAAGAATTGGTG
CTTAGGAGAACGACATGGGTTGGAAATTCC|TTTTCCTAGCTGTAACGGGTGGCTCCTATA
TAAGAATTGTAAGAATTGATGTGTACTGCG|TGTGAGGAGATGTGACCATAAGAATTGAGA
TGGGCCCGTGTGAGGAGATGTGACCATAAG|TGGGTTGGAAATTCCGTGTGAGGAGATGTG
CCGTGTGAGGAGATGTGACCATAAGAATTG|TCCGTGTGAGGAGATGTGACCATAAGAATT
ACGGTGGCGGCCATACCGTGTGAGGAGATG|CTTCCGTGTGAGGAGATGTGACCATAAGAA
ACTAAGACTGCGCTATCCGGTTCCTTTTCG|TTTGGGCCCGTGTGAGGAGATGTGACCATA
ATGGGTTGGAAATTCCGTGTGAGGAGATGT|ACGGGTGGCTCCTATAAAAATGAGGGGATT
AGGACCAGTAAGAAGGGGACCCCGGGTCCA|AGTATCACATTGTACCAAATCAGTACCACC
TTAGATACGTTTTGAGAAAGGCCACTGATT|AAGGAGTAGTAGGGGTGTGGGGTAAAGAGA
GAGATGTGACCATAAGAATTGCAGCTAACT|TATGCCCACGGTGGCGGCCATACCGTGTGA
GACCATAAGAATTGATCCGTGTGAGGAGAT|TGGCCAATCACTAAATGGTTATCAGCGGAC
AAGAATTCCGTGTGAGGAGATGTGACCATA|GTGACCATAAGAATTGATCCGTGTGAGGAG
TTGTTTGAGCTTCCAGGACCAGTAAGAAGG|AGTTGCAAACTTCAAGTATCACATTGTACC
TAAATGCCCAGGGAGCCGGCGTGTACCATA|GATGTGACCATAAGAATTGCAGCTAACTTA
CATAAGAATTGAGACATAGACATTGCCAAC|AACTTGCAGACATCTTACCCGTTCAATCAG
GCCGTCCTCGATTTCACCTTCCGTGTGAGG|AAACGTACACGACTGTTATGCTGCACTGCG
TTTATGTAACCGTGTGAGGAGATGTGACCA|ATAATAGGCTGGGTATGGTATGCCCACGGT
AAGTATCACATTGTACCAAATCAGTACCAC|TTCGCGTTCAGAGAGGACTAGACTTAGGAG
TGTAAGAATTGATGTGTACTGCGCCTGTGC|AGATGTGACCATAAGAATTGAGACATAGAC
CCACCGTGTGAGGAGATGTGACCATAAGAA|CTTACCAATGACACCGTGATCCCGTGTGAG
TGTGAGGAGATGTGACCATAAGAATTGACC|TATCAGCGGACCGCAATTCGATTCTGAGGG
AGAATTGACCAACTGGCGCCGCGCGTGTTC|ATTCTGAGGGATGTCGTCTCTCAGCCGTAT
ACCGCGAAAGCGAGAGCGGTGATAAGAGAG|AGGAGATGTGACCATAAGAATTGTGCGTTT
GATAAGAGAGGCCATCTCAAACTTGCAGAC|TTGTGCGTTTTTGTCCAATGGTACGAATGG
GCCGCGCGTGTTCGTTGGCTTAGATCTGTT|CTCTCAGCCGTATGATAAGAAGCCGTGTAT
TTCCTTTTCGCACCACCGTGTGAGGAGATG|TGTGACCATAAGAATTCCGTGTGAGGAGAT
ATTTCACCTTCCGTGTGAGGAGATGTGACC|GACTGTTATGCTGCACTGCGCAACTTTGTC
CGTTTTTTCCTGTGGTGCAATAGCGTCCTT|TGAGACACTCCGGTAGAATTATCACTTTTA
CCGCGAAAGCGAGAGCGGTGATAAGAGAGG|GGAGATGTGACCATAAGAATTGTGCGTTTT
GTGACCATAAGAATTGGTGAGGAGATGTGA|AGGAGATGTGACCATAAGAATTGTAAGAAT
TACTGCGCCTGTGCATCTGGGTTGTCGATC|ATTGAGACATAGACATTGCCAACACACAGA
ATAAGAATTGCTTACCAATGACACCGTGAT|AGCCTTTGACGACCGCGAAAGCGAGAGCGG
CTGCACTGCGCAACTTTGTCAGCCTTTGAC|CTGATTTCTCTGTGTAGCCTGAGGCCGTGT
TTCACCTTCCGTGTGAGGAGATGTGACCAT|CTGTTATGCTGCACTGCGCAACTTTGTCAG
ATACCGTGTGAGGAGATGTGACCACCGTGT|GAGATGTGACCATAAGAATTGCTTACCAAT
CGTGTGAGGAGATGTGACCATAAGAATTGA|AAAAATGAGGGGATTTGGCCAATCACTAAA
TTTCCTGTGGTGCAATAGCGTCCTTTCAAC|CACTCCGGTAGAATTATCACTTTTATGTAA
ACCACCAAGATTTGGGCCCGTGTGAGGAGA|AGGAGAACGACATGGGTTGGAAATTCCGTG
TCGTGTTGACCGTATGAAAGGAGTAGTAGG|TCAAACTAAGACTGCGCTATCCGGTTCCTT
CTATATGGGCAGGGTATTCCGTGTGAGGAG|GTGAGGAGATGTGACCATAAGAATTGGTGA
CGGATCCGATTATAATAGGCTGGGTATGGT|ATCTGGGTTGTCGATCAGTGCCGTCCTCGA
AGAATTGTAAGAATTGATGTGTACTGCGCC|TGAGGAGATGTGACCATAAGAATTGAGACA
TGACCATAAGAATTGGTAAGCTTCCGGATC|AATTGATGTGTACTGCGCCTGTGCATCTGG
TGCCGTCCTCGATTTCACCTTCCGTGTGAG|GAAACGTACACGACTGTTATGCTGCACTGC
ACTGCGCTATCCGGTTCCTTTTCGCACCAC|CCCGTGTGAGGAGATGTGACCATAAGAATT
GTGCGTTTTTGTCCAATGGTACGAATGGCC|GCTTCCAGGACCAGTAAGAAGGGGACCCCG
TGAGGAGATGTGACCACCGTGTGAGGAGAT|ACCATAAGAATTGCTTACCAATGACACCGT
GTACCGTGTGAGGAGATGTGACCATAAGAA|ACCATAAGAATTGGCCGGCGTTCGTTGTTG
AGATGAGCAGGCGTACCGTGTGAGGAGATG|TGAGGAGATGTGACCATAAGAATTGGCCGG
ACCCCGGGTCCATCAAACTAAGACTGCGCT|ATCAGTACCACCAAGATTTGGGCCCGTGTG
TGTGACCATAAGAATTGGTGAGGAGATGTG|GAGGAGATGTGACCATAAGAATTGTAAGAA
TCCGGATCCGATTATAATAGGCTGGGTATG|GCATCTGGGTTGTCGATCAGTGCCGTCCTC
GAGATGTGACCATAAGAATTGACCAACTGG|CGGACCGCAATTCGATTCTGAGGGATGTCG
ATAGACATTGCCAACACACAGAGTGAAACG|TACCCGTTCAATCAGTAGCTGTTAGATACG
AGCGTTTTTTCCTGTGGTGCAATAGCGTCC|ATTGAGACACTCCGGTAGAATTATCACTTT
AGAATTGTGCGTTTTTGTCCAATGGTACGA|GTTTGAGCTTCCAGGACCAGTAAGAAGGGG
CCGATTATAATAGGCTGGGTATGGTATGCC|GGTTGTCGATCAGTGCCGTCCTCGATTTCA
TCAAGTATCACATTGTACCAAATCAGTACC|TATTCGCGTTCAGAGAGGACTAGACTTAGG
ATCAGTACCACCAAGATTTGGGCCCGTGTG|AGACTTAGGAGAACGACATGGGTTGGAAAT
CGCAACTTTGTCAGCCTTTGACGACCGCGA|TCTGTGTAGCCTGAGGCCGTGTGAGGAGAT
GTATTCGCGTTCAGAGAGGACTAGACTTAG|GCGTGTTCGTTGGCTTAGATCTGTTTTTTC
CGTTCAATCAGTAGCTGTTAGATACGTTTT|TCGTGTTGACCGTATGAAAGGAGTAGTAGG
CCTGAGGCCGTGTGAGGAGATGTGACCATA|ACCGTGTGAGGAGATGTGACCATAAGAATT
TGTGACCATAAGAATTGTAAGAATTGATGT|TGATCCCGTGTGAGGAGATGTGACCATAAG
ATTGATCCGTGTGAGGAGATGTGACCATAA|CTAAATGGTTATCAGCGGACCGCAATTCGA
TGTGACCATAAGAATTCCGTGTGAGGAGAT|TGAGGAGATGTGACCATAAGAATTGATCCG
AATTGGTCGAGCGATAGGGGCCATCGCAAC|GTGACCATAAGAATTGACCAACTGGCGCCG
CGTTGTTGAGTTGCAAACTTCAAGTATCAC|ATAGGGGCCATCGCAACGGTATTCGCGTTC
CAGGGAGCCGGCGTGTACCATACGGCAACG|CATAAGAATTGCAGCTAACTTACCGTCCGT
TGTTGAGTTGCAAACTTCAAGTATCACATT|GGGGCCATCGCAACGGTATTCGCGTTCAGA
ATTATAATAGGCTGGGTATGGTATGCCCAC|TGTCGATCAGTGCCGTCCTCGATTTCACCT
AATTGTAAGAATTGATGTGTACTGCGCCTG|AGGAGATGTGACCATAAGAATTGAGACATA
GTTGGAAATTCCGTGTGAGGAGATGTGACC|GTGGCTCCTATAAAAATGAGGGGATTTGGC
AGATGTGACCATAAGAATTGACCAACTGGC|GGACCGCAATTCGATTCTGAGGGATGTCGT
GGTAAAGAGATGAGCAGGCGTACCGTGTGA|CACCGTGTGAGGAGATGTGACCATAAGAAT
GACATAGACATTGCCAACACACAGAGTGAA|TCTTACCCGTTCAATCAGTAGCTGTTAGAT
CTGAGGCCGTGTGAGGAGATGTGACCATAA|CCGTGTGAGGAGATGTGACCATAAGAATTG
GGTGCAATAGCGTCCTTTCAACGAATCAAT|TAGAATTATCACTTTTATGTAACCGTGTGA
ACCATAAGAATTGGTGAGGAGATGTGACCA|AGATGTGACCATAAGAATTGTAAGAATTGA
CCAATGACACCGTGATCCCGTGTGAGGAGA|GCGAAAGCGAGAGCGGTGATAAGAGAGGCC
TGGTACGAATGGCCGTCGTGTCGTGTTGAC|AGAAGGGGACCCCGGGTCCATCAAACTAAG
GATGTGACCATAAGAATTGAGACACTCCGG|AGGAGATGTGACCATAAGAATTGGTAAGCT
GTGACCATAAGAATTGCAGCTAACTTACCG|CCACGGTGGCGGCCATACCGTGTGAGGAGA
TCACTTTTATGTAACCGTGTGAGGAGATGT|CGATTATAATAGGCTGGGTATGGTATGCCC
ATTGGTAAGCTTCCGGATCCGATTATAATA|ACTGCGCCTGTGCATCTGGGTTGTCGATCA
GATGTGACCATAAGAATTGTGCGTTTTTGT|ACCATAAGAATTGTTTGAGCTTCCAGGACC
TGAGGAGATGTGACCATAAGAATTGATCCG|ATGAGGGGATTTGGCCAATCACTAAATGGT
AATCCCTAGCGTTTTTTCCTGTGGTGCAAT|CATAAGAATTGAGACACTCCGGTAGAATTA
ATGTGACCATAAGAATTGGTGAGGAGATGT|TGAGGAGATGTGACCATAAGAATTGTAAGA
CCGTGTGAGGAGATGTGACCATAAGAATTG|AAGAATTGGTGAGGAGATGTGACCATAAGA
TTTGGGCCCGTGTGAGGAGATGTGACCATA|CATGGGTTGGAAATTCCGTGTGAGGAGATG
CCATAAGAATTGTAAGAATTGATGTGTACT|CCGTGTGAGGAGATGTGACCATAAGAATTG
AGAGAGGACTAGACTTAGGAGAACGACATG|GCTTAGATCTGTTTTTTCCTAGCTGTAACG
ATTGAGACATAGACATTGCCAACACACAGA|AGACATCTTACCCGTTCAATCAGTAGCTGT
GACCATAAGAATTGAGACACTCCGGTAGAA|ATGTGACCATAAGAATTGGTAAGCTTCCGG
CTTCCAGGACCAGTAAGAAGGGGACCCCGG|CTTCAAGTATCACATTGTACCAAATCAGTA
CGTGTCGTGTTGACCGTATGAAAGGAGTAG|TCCATCAAACTAAGACTGCGCTATCCGGTT
TGTGACCATAAGAATTGGCCGGCGTTCGTT|ATGTGACCATAAGAATTGGTCGAGCGATAG
TGGTGAGGAGATGTGACCATAAGAATTGGT|TAAGAATTGTAAGAATTGATGTGTACTGCG
CTGCGCTATCCGGTTCCTTTTCGCACCACC|CCGTGTGAGGAGATGTGACCATAAGAATTC
TTAAATGCCCAGGGAGCCGGCGTGTACCAT|AGATGTGACCATAAGAATTGCAGCTAACTT
AGATGTGACCATAAGAATTGGTGAGGAGAT|TGTGAGGAGATGTGACCATAAGAATTGTAA
GCGTACCGTGTGAGGAGATGTGACCATAAG|TGACCATAAGAATTGGCCGGCGTTCGTTGT
ATCGCAACGGTATTCGCGTTCAGAGAGGAC|TGGCGCCGCGCGTGTTCGTTGGCTTAGATC
TTTAAATGCCCAGGGAGCCGGCGTGTACCA|GAGATGTGACCATAAGAATTGCAGCTAACT
AACTTACCGTCCGTGTGAGGAGATGTGACC|GTGAGGAGATGTGACCACCGTGTGAGGAGA
CATAAGAATTGGTCGAGCGATAGGGGCCAT|GGAGATGTGACCATAAGAATTGACCAACTG
GATGTGTACTGCGCCTGTGCATCTGGGTTG|ATAAGAATTGAGACATAGACATTGCCAACA
CGTGATCCCGTGTGAGGAGATGTGACCATA|GAGCGGTGATAAGAGAGGCCATCTCAAACT
CGGTAGAATTATCACTTTTATGTAACCGTG|GCTTCCGGATCCGATTATAATAGGCTGGGT
ATTTGGGCCCGTGTGAGGAGATGTGACCAT|ACATGGGTTGGAAATTCCGTGTGAGGAGAT
GTACCACCAAGATTTGGGCCCGTGTGAGGA|TTAGGAGAACGACATGGGTTGGAAATTCCG
CGTACCGTGTGAGGAGATGTGACCATAAGA|GACCATAAGAATTGGCCGGCGTTCGTTGTT
GATGTGACCATAAGAATTGAGACATAGACA|CCATCTCAAACTTGCAGACATCTTACCCGT
AATTGAGACATAGACATTGCCAACACACAG|CAGACATCTTACCCGTTCAATCAGTAGCTG
CGTATGAAAGGAGTAGTAGGGGTGTGGGGT|ACTGCGCTATCCGGTTCCTTTTCGCACCAC
GAGCAGGCGTACCGTGTGAGGAGATGTGAC|GAGATGTGACCATAAGAATTGGCCGGCGTT
TTCCGTGTGAGGAGATGTGACCATAAGAAT|ATAAGAATTGGTGAGGAGATGTGACCATAA
TTTGAGCTTCCAGGACCAGTAAGAAGGGGA|TGCAAACTTCAAGTATCACATTGTACCAAA
TGATTTCTCTGTGTAGCCTGAGGCCGTGTG|AGAGATGAGCAGGCGTACCGTGTGAGGAGA
TGTGTAGCCTGAGGCCGTGTGAGGAGATGT|CAGGCGTACCGTGTGAGGAGATGTGACCAT
TGAGGAGATGTGACCATAAGAATTGGTCGA|ATTGATCCGTGTGAGGAGATGTGACCATAA
GGCGTTCGTTGTTGAGTTGCAAACTTCAAG|CGAGCGATAGGGGCCATCGCAACGGTATTC
ACGGTATTCGCGTTCAGAGAGGACTAGACT|CGCGCGTGTTCGTTGGCTTAGATCTGTTTT
GACCACCGTGTGAGGAGATGTGACCATAAG|TGCTTACCAATGACACCGTGATCCCGTGTG
TGTACTGCGCCTGTGCATCTGGGTTGTCGA|GAATTGAGACATAGACATTGCCAACACACA
GAATTGGTGAGGAGATGTGACCATAAGAAT|ACCATAAGAATTGTAAGAATTGATGTGTAC
ATTGTAAGAATTGATGTGTACTGCGCCTGT|GGAGATGTGACCATAAGAATTGAGACATAG
TGAGGAGATGTGACCATAAGAATTGTAAGA|TGACACCGTGATCCCGTGTGAGGAGATGTG
CGTCCGTGTGAGGAGATGTGACCATAAGAA|GATGTGACCACCGTGTGAGGAGATGTGACC
CGTGTGAGGAGATGTGACCATAAGAATTCC|GGAAATTCCGTGTGAGGAGATGTGACCATA
AGAATTGATCCGTGTGAGGAGATGTGACCA|TCACTAAATGGTTATCAGCGGACCGCAATT
AAGAATTGAGACACTCCGGTAGAATTATCA|CCATAAGAATTGGTAAGCTTCCGGATCCGA
GTTTTTGTCCAATGGTACGAATGGCCGTCG|CCAGGACCAGTAAGAAGGGGACCCCGGGTC
GGTACGAATGGCCGTCGTGTCGTGTTGACC|GAAGGGGACCCCGGGTCCATCAAACTAAGA
TCGATTTCACCTTCCGTGTGAGGAGATGTG|CACGACTGTTATGCTGCACTGCGCAACTTT
ATCAAACTAAGACTGCGCTATCCGGTTCCT|CAAGATTTGGGCCCGTGTGAGGAGATGTGA
AATTGCAGCTAACTTACCGTCCGTGTGAGG|GCCATACCGTGTGAGGAGATGTGACCACCG
AGGGAGCCGGCGTGTACCATACGGCAACGC|ATAAGAATTGCAGCTAACTTACCGTCCGTG
TATGCCCACGGTGGCGGCCATACCGTGTGA|ATTTCACCTTCCGTGTGAGGAGATGTGACC
CGATAGGGGCCATCGCAACGGTATTCGCGT|AATTGACCAACTGGCGCCGCGCGTGTTCGT
GGAGATGTGACCATAAGAATTGGTAAGCTT|TTGTAAGAATTGATGTGTACTGCGCCTGTG
TCCGGTAGAATTATCACTTTTATGTAACCG|AAGCTTCCGGATCCGATTATAATAGGCTGG
AGACATTGCCAACACACAGAGTGAAACGTA|CCCGTTCAATCAGTAGCTGTTAGATACGTT
GAATTGTTTGAGCTTCCAGGACCAGTAAGA|TTGAGTTGCAAACTTCAAGTATCACATTGT
TAGAATTATCACTTTTATGTAACCGTGTGA|TCCGGATCCGATTATAATAGGCTGGGTATG
ACCGTGTGAGGAGATGTGACCATAAGAATT|TACCAATGACACCGTGATCCCGTGTGAGGA
TTCGTTGTTGAGTTGCAAACTTCAAGTATC|CGATAGGGGCCATCGCAACGGTATTCGCGT
TTCAGAGAGGACTAGACTTAGGAGAACGAC|TTGGCTTAGATCTGTTTTTTCCTAGCTGTA
TGCATCTGGGTTGTCGATCAGTGCCGTCCT|GACATTGCCAACACACAGAGTGAAACGTAC
